klassenübergreifend	Allgemein
steigerungsspezifisch	Allgemein
groß	Allgemein
mittelgroß	Allgemein
weltgroß	Allgemein
superlativisch	Allgemein
größtmöglich	Allgemein
größt-	Allgemein
kleinstmöglich	Allgemein
kleinst-	Allgemein
enorm	Allgemein
unglaublich	Allgemein
stattlich	Allgemein
hünenhaft	Allgemein
riesengroß	Allgemein
riesenhaft	Allgemein
riesig	Allgemein
überdimensional	Allgemein
gigantisch	Allgemein
bombastisch	Allgemein
monströs	Allgemein
astronomisch	Allgemein
erheblich	Allgemein
ziemlich	Allgemein
gehörig	Allgemein
umfangreich	Allgemein
närrisch	Allgemein
beträchtlich	Allgemein
erklecklich	Allgemein
beachtlich	Allgemein
klein	Allgemein
unerheblich	Allgemein
unmaßgeblich	Allgemein
geringfügig	Allgemein
winzig	Allgemein
mikroskopisch	Allgemein
gnomenhaft	Allgemein
pygmäenhaft	Allgemein
zwergenhaft	Allgemein
mickrig	Allgemein
klitzeklein	Allgemein
knapp	Allgemein
unzureichend	Allgemein
begrenzt	Allgemein
eingeschränkt	Allgemein
limitiert	Allgemein
delimitiert	Allgemein
befristet	Allgemein
unbegrenzt	Allgemein
unlimitiert	Allgemein
reduktionistisch	Allgemein
minimalistisch	Allgemein
stark	Allgemein
mörderisch	Allgemein
brutal	Allgemein
höllisch	Allgemein
intensiv	Allgemein
hochgradig	Allgemein
verstärkt	Allgemein
betont	Allgemein
hervorgehoben	Allgemein
akzentuiert	Allgemein
emphatisch	Allgemein
auffällig	Allgemein
auffallend	Allgemein
provokant	Allgemein
demonstrativ	Allgemein
ostentativ	Allgemein
ausgeprägt	Allgemein
hervorstechend	Allgemein
markant	Allgemein
markig	Allgemein
kernig	Allgemein
spektakulär	Allgemein
einprägsam	Allgemein
prägnant	Allgemein
plakativ	Allgemein
unübersehbar	Allgemein
verdächtig	Allgemein
suspekt	Allgemein
beachtet	Allgemein
unbeachtet	Allgemein
unbeobachtet	Allgemein
unbemerkt	Allgemein
ungesehen	Allgemein
ungehört	Allgemein
verstohlen	Allgemein
unverdächtig	Allgemein
unscheinbar	Allgemein
unspektakulär	Allgemein
ausgesprochen	Allgemein
weitgehend	Allgemein
weitführend	Allgemein
weitreichend	Allgemein
folgenschwer	Allgemein
folgenreich	Allgemein
abendfüllend	Allgemein
ausweitbar	Allgemein
auswalzbar	Allgemein
gründlich	Allgemein
tiefgreifend	Allgemein
tiefschürfend	Allgemein
tiefgehend	Allgemein
radikal	Allgemein
extrem	Allgemein
totalitär	Allgemein
diktatorisch	Allgemein
linksradikal	Allgemein
linksextrem	Allgemein
linksextremistisch	Allgemein
rechtsradikal	Allgemein
rechtsextrem	Allgemein
rechtsextremistisch	Allgemein
gewaltig	Allgemein
heftig	Allgemein
eklatant	Allgemein
unvermindert	Allgemein
gewaltsam	Allgemein
hart	Allgemein
wuchtig	Allgemein
schwarz	Allgemein
unbändig	Allgemein
protzig	Allgemein
schwach	Allgemein
unauffällig	Allgemein
unauffallend	Allgemein
oberflächlich	Allgemein
klischeehaft	Allgemein
vordergründig	Allgemein
plakativ	Allgemein
hintergründig	Allgemein
tiefsinnig	Allgemein
tiefgründig	Allgemein
feingründig	Allgemein
subtil	Allgemein
abgründig	Allgemein
bewertungsspezifisch	Allgemein
gut	Allgemein
positiv	Allgemein
glücklich	Allgemein
blendend	Allgemein
unglücklich	Allgemein
verteufelt	Allgemein
glimpflich	Allgemein
besser	Allgemein
verbessernd	Allgemein
begünstigend	Allgemein
mildernd	Allgemein
strafmildernd	Allgemein
strafsenkend	Allgemein
fein	Allgemein
hervorragend	Allgemein
herausragend	Allgemein
vorzüglich	Allgemein
vortrefflich	Allgemein
bestechend	Allgemein
außerordentlich	Allgemein
außergewöhnlich	Allgemein
exzeptionell	Allgemein
ausgezeichnet	Allgemein
exzellent	Allgemein
perfekt	Allgemein
fehlerlos	Allgemein
fehlerfrei	Allgemein
unfehlbar	Allgemein
überragend	Allgemein
toll	Allgemein
cool	Allgemein
geil	Allgemein
fett	Allgemein
krass	Allgemein
super	Allgemein
top	Allgemein
doll	Allgemein
astrein	Allgemein
dufte	Allgemein
knorke	Allgemein
stark	Allgemein
fabelhaft	Allgemein
märchenhaft	Allgemein
prächtig	Allgemein
prachtvoll	Allgemein
prunkhaft	Allgemein
prunkvoll	Allgemein
pompös	Allgemein
fantastisch	Allgemein
phänomenal	Allgemein
sensationell	Allgemein
traumhaft	Allgemein
idyllisch	Allgemein
malerisch	Allgemein
legendenhaft	Allgemein
legendär	Allgemein
mythisch	Allgemein
Erfolg versprechend	Allgemein
prima	Allgemein
wunderbar	Allgemein
wundervoll	Allgemein
herrlich	Allgemein
himmlisch	Allgemein
paradiesisch	Allgemein
klasse	Allgemein
spitze	Allgemein
endgeil	Allgemein
marktführend	Allgemein
marktbeherrschend	Allgemein
unerreicht	Allgemein
unerreichbar	Allgemein
unnachahmlich	Allgemein
uneinholbar	Allgemein
erstklassig	Allgemein
meisterhaft	Allgemein
meisterlich	Allgemein
virtuos	Allgemein
kunstfertig	Allgemein
großartig	Allgemein
grandios	Allgemein
berauschend	Allgemein
hochklassig	Allgemein
hochwertig	Allgemein
elefantös	Allgemein
ideal	Allgemein
eingängig	Allgemein
gefällig	Allgemein
gehoben	Allgemein
geeignet	Allgemein
günstig	Allgemein
tauglich	Allgemein
waffenfähig	Allgemein
verkehrstauglich	Allgemein
verkehrssicher	Allgemein
verkehrsuntauglich	Allgemein
wehrdienstfähig	Allgemein
wehrtauglich	Allgemein
wehruntauglich	Allgemein
fähig	Allgemein
verdienstvoll	Allgemein
verdient	Allgemein
würdig	Allgemein
lebensfähig	Allgemein
lebensunfähig	Allgemein
ehrwürdig	Allgemein
altehrwürdig	Allgemein
erhaltenswert	Allgemein
gelungen	Allgemein
gut geraten	Allgemein
geraten	Allgemein
prädestiniert	Allgemein
auserwählt	Allgemein
vorbestimmt	Allgemein
auserkoren	Allgemein
geboren	Allgemein
erkoren	Allgemein
auserlesen	Allgemein
ausgesucht	Allgemein
erlaucht	Allgemein
gesucht	Allgemein
ausersehen	Allgemein
handlungsfähig	Allgemein
wettbewerbsfähig	Allgemein
konkurrenzfähig	Allgemein
anpassungsfähig	Allgemein
wandlungsfähig	Allgemein
beschlussfähig	Allgemein
mehrheitsfähig	Allgemein
arbeitsfähig	Allgemein
einsatzfähig	Allgemein
arbeitsunfähig	Allgemein
außerstande	Allgemein
imstande	Allgemein
zurechnungsfähig	Allgemein
unzurechnungsfähig	Allgemein
handlungsunfähig	Allgemein
genehm	Allgemein
akzeptabel	Allgemein
begrüßenswert	Allgemein
bizarr	Allgemein
pittoresk	Allgemein
vertretbar	Allgemein
einnehmbar	Allgemein
annehmbar	Allgemein
hinnehmbar	Allgemein
passabel	Allgemein
attraktiv	Allgemein
nützlich	Allgemein
nutzbringend	Allgemein
dienlich	Allgemein
hilfreich	Allgemein
subsidiär	Allgemein
unterstützend	Allgemein
mannschaftsdienlich	Allgemein
mannschaftstauglich	Allgemein
lohnend	Allgemein
lohnenswert	Allgemein
aussichtsreich	Allgemein
vielversprechend	Allgemein
verheißungsvoll	Allgemein
verlockend	Allgemein
förderungswürdig	Allgemein
effektiv	Allgemein
praktisch	Allgemein
handlich	Allgemein
handhabbar	Allgemein
pragmatisch	Allgemein
erfolgreich	Allgemein
erfolgsverwöhnt	Allgemein
erfolgsgewöhnt	Allgemein
siegreich	Allgemein
fündig	Allgemein
unbesiegt	Allgemein
ungeschlagen	Allgemein
chancenreich	Allgemein
perspektivreich	Allgemein
zukunftsweisend	Allgemein
zukunftsträchtig	Allgemein
wegweisend	Allgemein
zukunftsweisend	Allgemein
glückreich	Allgemein
moralisch	Allgemein
sittlich	Allgemein
ethisch	Allgemein
ehrenhaft	Allgemein
ehrenvoll	Allgemein
prestigeträchtig	Allgemein
imageträchtig	Allgemein
erstrebenswert	Allgemein
sinnvoll	Allgemein
sinnig	Allgemein
ergebnisreich	Allgemein
zweckmäßig	Allgemein
optimal	Allgemein
bestmöglich	Allgemein
angenehm	Allgemein
freundlich	Allgemein
schlecht	Allgemein
negativ	Allgemein
ungünstig	Allgemein
unakzeptabel	Allgemein
inakzeptabel	Allgemein
unannehmbar	Allgemein
unvertretbar	Allgemein
bodenlos	Allgemein
empörend	Allgemein
entwürdigend	Allgemein
ungeeignet	Allgemein
ungut	Allgemein
unschön	Allgemein
untauglich	Allgemein
unfähig	Allgemein
laienhaft	Allgemein
unprofessionell	Allgemein
nichtsnutzig	Allgemein
nutzlos	Allgemein
unnütz	Allgemein
unnützlich	Allgemein
erfolglos	Allgemein
fehlgeschlagen	Allgemein
schiefgegangen	Allgemein
schiefgelaufen	Allgemein
danebengegangen	Allgemein
mau	Allgemein
chancenlos	Allgemein
glücklos	Allgemein
sinnlos	Allgemein
unsinnig	Allgemein
absurd	Allgemein
abstrus	Allgemein
aberwitzig	Allgemein
irrwitzig	Allgemein
ergebnislos	Allgemein
zwecklos	Allgemein
zweckfrei	Allgemein
unzweckmäßig	Allgemein
misslungen	Allgemein
missraten	Allgemein
fehlerhaft	Allgemein
stümperhaft	Allgemein
dilettantisch	Allgemein
schlimm	Allgemein
schäbig	Allgemein
miserabel	Allgemein
erträglich	Allgemein
leidlich	Allgemein
annehmbar	Allgemein
zumutbar	Allgemein
aushaltbar	Allgemein
unhaltbar	Allgemein
untragbar	Allgemein
tragbar	Allgemein
tragfähig	Allgemein
haltbar	Allgemein
tückisch	Allgemein
unerträglich	Allgemein
unzumutbar	Allgemein
arg	Allgemein
übel	Allgemein
ruchbar	Allgemein
böse	Allgemein
eklig	Allgemein
ekelerregend	Allgemein
verheerend	Allgemein
katastrophal	Allgemein
vernichtend	Allgemein
traumatisch	Allgemein
traumatisierend	Allgemein
anrüchig	Allgemein
unpraktisch	Allgemein
bescheiden	Allgemein
beschissen	Allgemein
oll	Allgemein
ätzend	Allgemein
mistig	Allgemein
widrig	Allgemein
richtig	Allgemein
zutreffend	Allgemein
korrekt	Allgemein
wahr	Allgemein
wahrhaft	Allgemein
wahrhaftig	Allgemein
unabweisbar	Allgemein
unverfälscht	Allgemein
originalgetreu	Allgemein
stilecht	Allgemein
recht	Allgemein
unrecht	Allgemein
echt	Allgemein
unecht	Allgemein
verkehrt	Allgemein
umgekehrt	Allgemein
regulär	Allgemein
vorschriftsmäßig	Allgemein
ordnungsgemäß	Allgemein
angemessen	Allgemein
adäquat	Allgemein
sachgemäß	Allgemein
sachgerecht	Allgemein
naturgemäß	Allgemein
sachgemäß	Allgemein
passend	Allgemein
angebracht	Allgemein
opportun	Allgemein
konform	Allgemein
übereinstimmend	Allgemein
verfassungskonform	Allgemein
staatskonform	Allgemein
verfassungsgemäß	Allgemein
verfassungstreu	Allgemein
moderat	Allgemein
gemäßigt	Allgemein
maßvoll	Allgemein
empfehlenswert	Allgemein
ratsam	Allgemein
nachahmenswert	Allgemein
hoffähig	Allgemein
standesgemäß	Allgemein
statthaft	Allgemein
ausgewogen	Allgemein
umsichtig	Allgemein
differenziert	Allgemein
einvernehmlich	Allgemein
gütlich	Allgemein
begründet	Allgemein
fundiert	Allgemein
unterlegt	Allgemein
stichhaltig	Allgemein
handfest	Allgemein
fadenscheinig	Allgemein
vorgeschoben	Allgemein
unbegründet	Allgemein
grundlos	Allgemein
berechtigt	Allgemein
befugt	Allgemein
rechtmäßig	Allgemein
legitim	Allgemein
angestammt	Allgemein
zustehend	Allgemein
ererbt	Allgemein
gerechtfertigt	Allgemein
erziehungsberechtigt	Allgemein
wahlberechtigt	Allgemein
weisungsbefugt	Allgemein
unrechtmäßig	Allgemein
illegitim	Allgemein
unberechtigt	Allgemein
unbefugt	Allgemein
ungerechtfertigt	Allgemein
unverhältnismäßig	Allgemein
ungerecht	Allgemein
unverdient	Allgemein
schmeichelhaft	Allgemein
ungehörig	Allgemein
unerhört	Allgemein
unpassend	Allgemein
unangebracht	Allgemein
deplaziert	Allgemein
deplatziert	Allgemein
ungelegen	Allgemein
falsch	Allgemein
unrichtig	Allgemein
unzutreffend	Allgemein
irregulär	Allgemein
irrtümlich	Allgemein
fälschlich	Allgemein
unwahr	Allgemein
gelogen	Allgemein
erlogen	Allgemein
gefälscht	Allgemein
vorgetäuscht	Allgemein
gespielt	Allgemein
vermeintlich	Allgemein
angeblich	Allgemein
vorgeblich	Allgemein
nominell	Allgemein
täuschend	Allgemein
trügerisch	Allgemein
irreführend	Allgemein
fehlleitend	Allgemein
verwirrend	Allgemein
irritierend	Allgemein
unangemessen	Allgemein
inadäquat	Allgemein
verfehlt	Allgemein
behindertengerecht	Allgemein
fachgerecht	Allgemein
rollstuhlgerecht	Allgemein
fahrstuhlgerecht	Allgemein
wirklich	Allgemein
real	Allgemein
realistisch	Allgemein
tatsächlich	Allgemein
faktisch	Allgemein
gegenständlich	Allgemein
leibhaftig	Allgemein
fiktiv	Allgemein
erfunden	Allgemein
imaginär	Allgemein
dokumentarisch	Allgemein
authentisch	Allgemein
reell	Allgemein
eigentlich	Allgemein
richtig	Allgemein
regelrecht	Allgemein
richtiggehend	Allgemein
glaubhaft	Allgemein
plausibel	Allgemein
glaubwürdig	Allgemein
unwirklich	Allgemein
irreal	Allgemein
fantastisch	Allgemein
utopisch	Allgemein
illusorisch	Allgemein
unrealisierbar	Allgemein
unrealistisch	Allgemein
wirklichkeitsfremd	Allgemein
weltfremd	Allgemein
lebensfern	Allgemein
illusionär	Allgemein
praxisfremd	Allgemein
implausibel	Allgemein
unglaubhaft	Allgemein
unglaubwürdig	Allgemein
hanebüchen	Allgemein
aktiv	Allgemein
offensiv	Allgemein
draufgängerisch	Allgemein
kämpferisch	Allgemein
dynamisch	Allgemein
beweglich	Allgemein
defensiv	Allgemein
abwartend	Allgemein
verhalten	Allgemein
zögerlich	Allgemein
verzagt	Allgemein
zauderhaft	Allgemein
tatenlos	Allgemein
untätig	Allgemein
ausgeliefert	Allgemein
preisgegeben	Allgemein
kampflos	Allgemein
widerstandslos	Allgemein
statisch	Allgemein
unbeweglich	Allgemein
passiv	Allgemein
normspezifisch	Allgemein
normal	Allgemein
anormal	Allgemein
sonderbar	Allgemein
pervers	Allgemein
abartig	Allgemein
deviant	Allgemein
abweichend	Allgemein
grotesk	Allgemein
skurril	Allgemein
absonderlich	Allgemein
seltsam	Allgemein
komisch	Allgemein
kurios	Allgemein
merkwürdig	Allgemein
eigenartig	Allgemein
eigentümlich	Allgemein
denkwürdig	Allgemein
obskur	Allgemein
zweifelhaft	Allgemein
dubios	Allgemein
andersartig	Allgemein
anderslautend	Allgemein
anders	Allgemein
anderssprachig	Allgemein
andersgläubig	Allgemein
normal	Allgemein
Computereigenschaft	Allgemein
softwarespezifisch	Allgemein
anwendungsbezogen	Allgemein
hardwarespezifisch	Allgemein
kompatibel	Allgemein
inkompatibel	Allgemein
verbunden	Allgemein
online	Allgemein
alphanumerisch	Allgemein
deterministisch	Allgemein
lossless	Allgemein
verlustlos	Allgemein
quick-and-dirty	Allgemein
textbasiert	Allgemein
interaktiv	Allgemein
virtuell	Allgemein
virtual	Allgemein
grafisch	Allgemein
remote	Allgemein
hierarchisch	Allgemein
bootfähig	Allgemein
breitbandig	Allgemein
crossmedial	Allgemein
digitaltauglich	Allgemein
downloadbar	Allgemein
herunterladbar	Allgemein
echtzeitfähig	Allgemein
interoperabel	Allgemein
javafähig	Allgemein
klickbar	Allgemein
anklickbar	Allgemein
netzübergreifend	Allgemein
netzwerkübergreifend	Allgemein
onlinefähig	Allgemein
paketvermittelt	Allgemein
pixelig	Allgemein
quelloffen	Allgemein
open source	Allgemein
scrollbar	Allgemein
verlinkt	Allgemein
webbasiert	Allgemein
webfähig	Allgemein
wiederbeschreibbar	Allgemein
zoombar	Allgemein
gelegen	Allgemein
verbessert	Allgemein
verändert	Allgemein
gescheitert	Allgemein
gutartig	Allgemein
winzigklein	Allgemein
großformatig	Allgemein
lebensgroß	Allgemein
übergroß	Allgemein
überlebensgroß	Allgemein
gleichgroß	Allgemein
faustgroß	Allgemein
erbsengroß	Allgemein
handtellergroß	Allgemein
normalgroß	Allgemein
millimetergroß	Allgemein
handgroß	Allgemein
menschengroß	Allgemein
mannsgroß	Allgemein
tennisballgroß	Allgemein
großrahmig	Allgemein
großdimensional	Allgemein
nicht deterministisch	Allgemein
nicht enzyklopädisch	Allgemein
sintflutartig	Allgemein
beispielhaft	Allgemein
vorbildlich	Allgemein
mustergültig	Allgemein
maßlos	Allgemein
unmäßig	Allgemein
übertrieben	Allgemein
scheiß	Allgemein
beknackt	Allgemein
nicht negativ	Allgemein
nicht passiv	Allgemein
nicht ideal	Allgemein
nicht aktiv	Allgemein
anstehend	Allgemein
dahinterstehend	Allgemein
bewegungsspezifisch	Bewegung
fließend	Bewegung
gleitend	Bewegung
harmonisch	Bewegung
geschmeidig	Bewegung
elegant	Bewegung
beschwingt	Bewegung
schwungvoll	Bewegung
abgehackt	Bewegung
unharmonisch	Bewegung
eckig	Bewegung
kantig	Bewegung
zackig	Bewegung
leicht	Bewegung
grazil	Bewegung
graziös	Bewegung
anmutig	Bewegung
heftig	Bewegung
vehement	Bewegung
ungestüm	Bewegung
turbulent	Bewegung
unruhig	Bewegung
furios	Bewegung
mitreißend	Bewegung
plump	Bewegung
gravitätisch	Bewegung
schwerfällig	Bewegung
behäbig	Bewegung
wild	Bewegung
zappelig	Bewegung
hektisch	Bewegung
starr	Bewegung
unbeweglich	Bewegung
unflexibel	Bewegung
fest	Bewegung
steif	Bewegung
hölzern	Bewegung
holprig	Bewegung
staksig	Bewegung
ungelenk	Bewegung
ungelenkig	Bewegung
fix	Bewegung
gegeben	Bewegung
feststehend	Bewegung
steckengeblieben	Bewegung
stehengeblieben	Bewegung
beweglich	Bewegung
mobil	Bewegung
rhythmisch	Bewegung
gelenkig	Bewegung
biegsam	Bewegung
flexibel	Bewegung
verstellbar	Bewegung
umstellbar	Bewegung
elastisch	Bewegung
dehnbar	Bewegung
positionsspezifisch	Bewegung
sitzend	Bewegung
stehend	Bewegung
liegend	Bewegung
hockend	Bewegung
kauernd	Bewegung
ruhend	Bewegung
laufend	Bewegung
fliegend	Bewegung
gehend	Bewegung
schreitend	Bewegung
rennend	Bewegung
rasend	Bewegung
steigend	Bewegung
ansteigend	Bewegung
fallend	Bewegung
sinkend	Bewegung
absinkend	Bewegung
wachsend	Bewegung
gegenüberliegend	Bewegung
schlangenartig	Bewegung
abstehend	Bewegung
gegenüberstehend	Bewegung
gefühlsspezifisch	Gefuehl
Gefühl empfindend	Gefuehl
gefühlsmäßig	Gefuehl
instinktiv	Gefuehl
instinktgetrieben	Gefuehl
instinktgesteuert	Gefuehl
gefühlvoll	Gefuehl
feierlich	Gefuehl
pathetisch	Gefuehl
schwülstig	Gefuehl
gemütsvoll	Gefuehl
romantisch	Gefuehl
emotional	Gefuehl
emotionell	Gefuehl
beseelt	Gefuehl
seelenvoll	Gefuehl
herzlich	Gefuehl
innig	Gefuehl
sensibel	Gefuehl
einfühlsam	Gefuehl
intuitiv	Gefuehl
mitfühlend	Gefuehl
mitleidend	Gefuehl
tröstlich	Gefuehl
tröstend	Gefuehl
trostspendend	Gefuehl
verständig	Gefuehl
verständnisvoll	Gefuehl
augenzwinkernd	Gefuehl
nachsichtig	Gefuehl
rücksichtsvoll	Gefuehl
empfindlich	Gefuehl
empfindsam	Gefuehl
verletzlich	Gefuehl
verletzbar	Gefuehl
verwundbar	Gefuehl
mimosenhaft	Gefuehl
zimperlich	Gefuehl
zartbesaitet	Gefuehl
dünnhäutig	Gefuehl
überempfindlich	Gefuehl
feinnervig	Gefuehl
feinfühlig	Gefuehl
mitleidig	Gefuehl
sentimental	Gefuehl
rührselig	Gefuehl
sehnsüchtig	Gefuehl
sehnsuchtsvoll	Gefuehl
nostalgisch	Gefuehl
gefühllos	Gefuehl
gefühlsarm	Gefuehl
gefühlskalt	Gefuehl
kühl	Gefuehl
unterkühlt	Gefuehl
sachlich	Gefuehl
knochentrocken	Gefuehl
dröge	Gefuehl
unsachlich	Gefuehl
hartherzig	Gefuehl
hart	Gefuehl
kalt	Gefuehl
kaltherzig	Gefuehl
verletzend	Gefuehl
unsensibel	Gefuehl
schroff	Gefuehl
brüsk	Gefuehl
unempfindlich	Gefuehl
unverwundbar	Gefuehl
dickfellig	Gefuehl
dickhäutig	Gefuehl
unantastbar	Gefuehl
unangreifbar	Gefuehl
unerschütterlich	Gefuehl
unerschrocken	Gefuehl
glücklich	Gefuehl
strahlend	Gefuehl
glückstrahlend	Gefuehl
überglücklich	Gefuehl
seelig	Gefuehl
froh	Gefuehl
froh gestimmt	Gefuehl
zufrieden	Gefuehl
ungetrübt	Gefuehl
hochzufrieden	Gefuehl
fröhlich	Gefuehl
vergnügt	Gefuehl
quietschvergnügt	Gefuehl
beschwingt	Gefuehl
heiter	Gefuehl
fidel	Gefuehl
unbeschwert	Gefuehl
ausgelassen	Gefuehl
euphorisch	Gefuehl
überschäumend	Gefuehl
überbordend	Gefuehl
leichtsinnig	Gefuehl
leichtfertig	Gefuehl
übermütig	Gefuehl
gut aufgelegt	Gefuehl
launig	Gefuehl
gut gelaunt	Gefuehl
frohgemut	Gefuehl
leichtfüßig	Gefuehl
aufgekratzt	Gefuehl
aufgedreht	Gefuehl
überschwänglich	Gefuehl
lebenslustig	Gefuehl
lebensfroh	Gefuehl
lebensbejahend	Gefuehl
lustbetont	Gefuehl
lustvoll	Gefuehl
erleichtert	Gefuehl
heilfroh	Gefuehl
befreit	Gefuehl
erlöst	Gefuehl
beruhigt	Gefuehl
dankbar	Gefuehl
ernst	Gefuehl
ernsthaft	Gefuehl
übellaunig	Gefuehl
schlecht gelaunt	Gefuehl
grantig	Gefuehl
grimmig	Gefuehl
mürrisch	Gefuehl
verdrossen	Gefuehl
muffig	Gefuehl
verstimmt	Gefuehl
missgestimmt	Gefuehl
misslaunig	Gefuehl
missgelaunt	Gefuehl
knatschig	Gefuehl
quengelig	Gefuehl
nörgelig	Gefuehl
nölig	Gefuehl
nörglerisch	Gefuehl
traurig	Gefuehl
freudlos	Gefuehl
verbittert	Gefuehl
bitter	Gefuehl
verhärtet	Gefuehl
vergrämt	Gefuehl
vergrätzt	Gefuehl
unglücklich	Gefuehl
unzufrieden	Gefuehl
todunglücklich	Gefuehl
todtraurig	Gefuehl
bedrückt	Gefuehl
einsam	Gefuehl
allein	Gefuehl
reumütig	Gefuehl
verlassen	Gefuehl
vereinsamt	Gefuehl
vereinzelt	Gefuehl
tieftraurig	Gefuehl
untröstlich	Gefuehl
betroffen	Gefuehl
leidtragend	Gefuehl
bedröppelt	Gefuehl
begossen	Gefuehl
gelackmeiert	Gefuehl
beschämt	Gefuehl
wehmütig	Gefuehl
bekümmert	Gefuehl
melancholisch	Gefuehl
deprimiert	Gefuehl
schwermütig	Gefuehl
grüblerisch	Gefuehl
nachdenklich	Gefuehl
versonnen	Gefuehl
gedankenverloren	Gefuehl
gedankenvoll	Gefuehl
versunken	Gefuehl
kontemplativ	Gefuehl
meditativ	Gefuehl
trübsinnig	Gefuehl
verärgert	Gefuehl
ärgerlich	Gefuehl
wütend	Gefuehl
wild	Gefuehl
zornig	Gefuehl
erzürnt	Gefuehl
empört	Gefuehl
entrüstet	Gefuehl
indigniert	Gefuehl
böse	Gefuehl
bitterböse	Gefuehl
beleidigt	Gefuehl
gekränkt	Gefuehl
sauer	Gefuehl
verletzt	Gefuehl
pikiert	Gefuehl
eingeschnappt	Gefuehl
nachtragend	Gefuehl
unversöhnlich	Gefuehl
vorwurfsvoll	Gefuehl
erbost	Gefuehl
aufgebracht	Gefuehl
schockiert	Gefuehl
geschockt	Gefuehl
paralysiert	Gefuehl
gelähmt	Gefuehl
erbittert	Gefuehl
fuchsteufelswild	Gefuehl
fuchsig	Gefuehl
optimistisch	Gefuehl
hoffnungsvoll	Gefuehl
erwartungsvoll	Gefuehl
hoffnungsfroh	Gefuehl
zuversichtlich	Gefuehl
sorgenfrei	Gefuehl
sorglos	Gefuehl
leichtherzig	Gefuehl
unbekümmert	Gefuehl
versöhnlich	Gefuehl
sicher	Gefuehl
fest	Gefuehl
überzeugt	Gefuehl
bombensicher	Gefuehl
felsenfest	Gefuehl
untrüglich	Gefuehl
unbestritten	Gefuehl
unstrittig	Gefuehl
unumstritten	Gefuehl
unangefochten	Gefuehl
unfraglich	Gefuehl
unzweifelhaft	Gefuehl
ungefährdet	Gefuehl
unumstößlich	Gefuehl
unbestreitbar	Gefuehl
unanfechtbar	Gefuehl
eifersüchtig	Gefuehl
missgünstig	Gefuehl
neidisch	Gefuehl
abwertend	Gefuehl
rachsüchtig	Gefuehl
pessimistisch	Gefuehl
hoffnungslos	Gefuehl
verzweifelt	Gefuehl
niedergeschlagen	Gefuehl
niedergedrückt	Gefuehl
gedrückt	Gefuehl
down	Gefuehl
gebrochen	Gefuehl
geknickt	Gefuehl
besorgt	Gefuehl
sorgenvoll	Gefuehl
beunruhigt	Gefuehl
zweifelnd	Gefuehl
unsicher	Gefuehl
mutlos	Gefuehl
zuversichtslos	Gefuehl
lebensmüde	Gefuehl
erregt	Gefuehl
entspannt	Gefuehl
relaxed	Gefuehl
chillig	Gefuehl
ausgeruht	Gefuehl
gespannt	Gefuehl
angespannt	Gefuehl
überspannt	Gefuehl
belastet	Gefuehl
überlastet	Gefuehl
überbelastet	Gefuehl
überfordert	Gefuehl
überarbeitet	Gefuehl
überdreht	Gefuehl
aufgeregt	Gefuehl
panisch	Gefuehl
panikartig	Gefuehl
exaltiert	Gefuehl
überkandidelt	Gefuehl
theatralisch	Gefuehl
übertrieben	Gefuehl
ergriffen	Gefuehl
bewegt	Gefuehl
verzückt	Gefuehl
entrückt	Gefuehl
verzaubert	Gefuehl
ekstatisch	Gefuehl
tief bewegt	Gefuehl
erschüttert	Gefuehl
krisenerschüttert	Gefuehl
krisengeschüttelt	Gefuehl
krisengebeutelt	Gefuehl
erstaunt	Gefuehl
überrascht	Gefuehl
verblüfft	Gefuehl
verdutzt	Gefuehl
kopfschüttelnd	Gefuehl
überwältigt	Gefuehl
übermannt	Gefuehl
interessiert	Gefuehl
angeregt	Gefuehl
motiviert	Gefuehl
kritisch	Gefuehl
gleichgültig	Gefuehl
uninteressiert	Gefuehl
desinteressiert	Gefuehl
indifferent	Gefuehl
selbstkritisch	Gefuehl
unmotiviert	Gefuehl
demotiviert	Gefuehl
unkritisch	Gefuehl
schweigend	Gefuehl
gelangweilt	Gefuehl
egal	Gefuehl
wurstig	Gefuehl
apathisch	Gefuehl
beeindruckt	Gefuehl
fasziniert	Gefuehl
hingerissen	Gefuehl
neugierig	Gefuehl
wissbegierig	Gefuehl
wissensdurstig	Gefuehl
ästhetisch	Gefuehl
feinsinnig	Gefuehl
feingeistig	Gefuehl
begeistert	Gefuehl
musikbegeistert	Gefuehl
musikinteressiert	Gefuehl
sportbegeistert	Gefuehl
sportinteressiert	Gefuehl
literaturbegeistert	Gefuehl
literaturinteressiert	Gefuehl
kunstbegeistert	Gefuehl
kunstinteressiert	Gefuehl
theaterbegeistert	Gefuehl
theaterinteressiert	Gefuehl
filmbegeistert	Gefuehl
filminteressiert	Gefuehl
enthusiastisch	Gefuehl
idealistisch	Gefuehl
glühend	Gefuehl
leidenschaftlich	Gefuehl
frenetisch	Gefuehl
rasend	Gefuehl
heftig	Gefuehl
furios	Gefuehl
inbrünstig	Gefuehl
schwärmerisch	Gefuehl
träumerisch	Gefuehl
verwirrt	Gefuehl
seltsam	Gefuehl
komisch	Gefuehl
ratlos	Gefuehl
hilflos	Gefuehl
Gefühl erweckend	Gefuehl
tieftraurig	Gefuehl
trostlos	Gefuehl
trist	Gefuehl
enttäuscht	Gefuehl
trübselig	Gefuehl
betrübt	Gefuehl
melancholisch	Gefuehl
deprimierend	Gefuehl
schwermütig	Gefuehl
misslich	Gefuehl
unerfreulich	Gefuehl
schade	Gefuehl
bedauerlich	Gefuehl
bedauernswert	Gefuehl
unerquicklich	Gefuehl
entmutigend	Gefuehl
demoralisierend	Gefuehl
niederschmetternd	Gefuehl
froh	Gefuehl
wehmütig	Gefuehl
freudig	Gefuehl
erfreulich	Gefuehl
erquicklich	Gefuehl
fröhlich	Gefuehl
heiter	Gefuehl
lustig	Gefuehl
witzig	Gefuehl
komisch	Gefuehl
spaßig	Gefuehl
spaßhaft	Gefuehl
scherzhaft	Gefuehl
tragikomisch	Gefuehl
saukomisch	Gefuehl
urkomisch	Gefuehl
lächerlich	Gefuehl
lachhaft	Gefuehl
drollig	Gefuehl
possenhaft	Gefuehl
ernst	Gefuehl
ernsthaft	Gefuehl
humorlos	Gefuehl
bitter	Gefuehl
ärgerlich	Gefuehl
lächerlich	Gefuehl
peinlich	Gefuehl
schmählich	Gefuehl
schmachvoll	Gefuehl
zweifelhaft	Gefuehl
fraglich	Gefuehl
anfechtbar	Gefuehl
angreifbar	Gefuehl
fragwürdig	Gefuehl
umstritten	Gefuehl
kontrovers	Gefuehl
strittig	Gefuehl
streitig	Gefuehl
erregend	Gefuehl
erotisch	Gefuehl
stimulierend	Gefuehl
unerotisch	Gefuehl
mitleiderregend	Gefuehl
ergreifend	Gefuehl
bewegend	Gefuehl
rührend	Gefuehl
herzbewegend	Gefuehl
herzzerreißend	Gefuehl
herzergreifend	Gefuehl
erschütternd	Gefuehl
sentimental	Gefuehl
rührselig	Gefuehl
anregend	Gefuehl
erfrischend	Gefuehl
ermunternd	Gefuehl
erquickend	Gefuehl
erlabend	Gefuehl
belebend	Gefuehl
aktivierend	Gefuehl
peinigend	Gefuehl
leidvoll	Gefuehl
leidgeplagt	Gefuehl
leidgeprüft	Gefuehl
qualvoll	Gefuehl
grausam	Gefuehl
quälend	Gefuehl
bohrend	Gefuehl
schmerzhaft	Gefuehl
schmerzvoll	Gefuehl
schmerzlich	Gefuehl
weh	Gefuehl
langweilig	Gefuehl
uninteressant	Gefuehl
fade	Gefuehl
öde	Gefuehl
eintönig	Gefuehl
einförmig	Gefuehl
monoton	Gefuehl
trocken	Gefuehl
dröge	Gefuehl
geisttötend	Gefuehl
ermüdend	Gefuehl
reizlos	Gefuehl
grau	Gefuehl
stinklangweilig	Gefuehl
sterbenslangweilig	Gefuehl
nichtssagend	Gefuehl
interessant	Gefuehl
lesenswert	Gefuehl
lesbar	Gefuehl
abwechslungsreich	Gefuehl
lehrreich	Gefuehl
vielseitig	Gefuehl
traurig	Gefuehl
freudlos	Gefuehl
variabel	Gefuehl
einseitig	Gefuehl
ansprechend	Gefuehl
einnehmend	Gefuehl
gewinnend	Gefuehl
sympathisch	Gefuehl
sympathieerweckend	Gefuehl
mannigfaltig	Gefuehl
vielfältig	Gefuehl
reichhaltig	Gefuehl
facettenreich	Gefuehl
faszinierend	Gefuehl
fesselnd	Gefuehl
begeisternd	Gefuehl
anregend	Gefuehl
erbaulich	Gefuehl
sehenswert	Gefuehl
sehenswürdig	Gefuehl
besinnlich	Gefuehl
stimmungsvoll	Gefuehl
anziehend	Gefuehl
attraktiv	Gefuehl
charismatisch	Gefuehl
lieblich	Gefuehl
liebreizend	Gefuehl
begehrenswert	Gefuehl
unwiderstehlich	Gefuehl
betörend	Gefuehl
verführerisch	Gefuehl
kokett	Gefuehl
charmant	Gefuehl
reizend	Gefuehl
entzückend	Gefuehl
bezückend	Gefuehl
hinreißend	Gefuehl
zauberhaft	Gefuehl
bezaubernd	Gefuehl
beeindruckend	Gefuehl
eindrucksvoll	Gefuehl
eindrücklich	Gefuehl
erstaunlich	Gefuehl
überraschend	Gefuehl
verblüffend	Gefuehl
ausdrucksvoll	Gefuehl
ausdrucksstark	Gefuehl
expressiv	Gefuehl
enttäuschend	Gefuehl
erschreckend	Gefuehl
schockierend	Gefuehl
skandalös	Gefuehl
skandalträchtig	Gefuehl
unterhaltsam	Gefuehl
kurzweilig	Gefuehl
bunt	Gefuehl
aufregend	Gefuehl
spektakulär	Gefuehl
aufsehenerregend	Gefuehl
abenteuerlich	Gefuehl
spannend	Gefuehl
dramatisch	Gefuehl
packend	Gefuehl
prickelnd	Gefuehl
reizvoll	Gefuehl
nervenzerreißend	Gefuehl
atemberaubend	Gefuehl
atemraubend	Gefuehl
schwindelerregend	Gefuehl
imposant	Gefuehl
imponierend	Gefuehl
bemerkenswert	Gefuehl
bewundernswert	Gefuehl
umwerfend	Gefuehl
überwältigend	Gefuehl
frappierend	Gefuehl
angenehm	Gefuehl
gemütlich	Gefuehl
behaglich	Gefuehl
geruhsam	Gefuehl
heimelig	Gefuehl
einladend	Gefuehl
wohltuend	Gefuehl
wohlig	Gefuehl
befriedigend	Gefuehl
zufriedenstellend	Gefuehl
unangenehm	Gefuehl
unbequem	Gefuehl
unbefriedigend	Gefuehl
ungemütlich	Gefuehl
unbehaglich	Gefuehl
unsympathisch	Gefuehl
abstoßend	Gefuehl
mulmig	Gefuehl
belastend	Gefuehl
bedrückend	Gefuehl
erdrückend	Gefuehl
schal	Gefuehl
beklemmend	Gefuehl
befremdlich	Gefuehl
beängstigend	Gefuehl
Unheil_verheißend	Gefuehl
unheilvoll	Gefuehl
unheilschwanger	Gefuehl
unheilig	Gefuehl
unselig	Gefuehl
düster	Gefuehl
schwarz	Gefuehl
besorgniserregend	Gefuehl
alarmierend	Gefuehl
unheimlich	Gefuehl
ungeheuer	Gefuehl
makaber	Gefuehl
beunruhigend	Gefuehl
bedenklich	Gefuehl
alptraumartig	Gefuehl
alptraumhaft	Gefuehl
schaudervoll	Gefuehl
schauderhaft	Gefuehl
schauerhaft	Gefuehl
schauerlich	Gefuehl
gruselig	Gefuehl
schaurig	Gefuehl
gespenstig	Gefuehl
grauenerregend	Gefuehl
geisterhaft	Gefuehl
gespensterhaft	Gefuehl
gespenstisch	Gefuehl
spukhaft	Gefuehl
schreckenerregend	Gefuehl
schrecklich	Gefuehl
furchtbar	Gefuehl
fürchterlich	Gefuehl
tragisch	Gefuehl
angsterregend	Gefuehl
furchterregend	Gefuehl
ekelerregend	Gefuehl
ekelhaft	Gefuehl
widerlich	Gefuehl
widerwärtig	Gefuehl
abscheulich	Gefuehl
verabscheuungswürdig	Gefuehl
scheußlich	Gefuehl
entsetzlich	Gefuehl
grausig	Gefuehl
grauenhaft	Gefuehl
grauenvoll	Gefuehl
grässlich	Gefuehl
gefährlich	Gefuehl
bedrohlich	Gefuehl
verhängnisvoll	Gefuehl
fatal	Gefuehl
lästig	Gefuehl
nervig	Gefuehl
leidig	Gefuehl
verdrießlich	Gefuehl
seltsam	Gefuehl
komisch	Gefuehl
geheimnisvoll	Gefuehl
magisch	Gefuehl
mystisch	Gefuehl
hermetisch	Gefuehl
dunkel	Gefuehl
undurchdringlich	Gefuehl
rätselhaft	Gefuehl
schleierhaft	Gefuehl
beschämend	Gefuehl
bildend	Gefuehl
isoliert	Gefuehl
nicht magisch	Gefuehl
bequem	Gefuehl
komfortabel	Gefuehl
humorvoll	Gefuehl
humorig	Gefuehl
verstehend	Gefuehl
geistspezifisch	Geist
intelligenzspezifisch	Geist
angeboren	Geist
vererbt	Geist
erblich	Geist
ererbt	Geist
erlernt	Geist
gelernt	Geist
erworben	Geist
rationell	Geist
verstandesmäßig	Geist
klug	Geist
intelligent	Geist
schlau	Geist
unintelligent	Geist
scharfsinnig	Geist
brillant	Geist
einfallsreich	Geist
ideenreich	Geist
originell	Geist
fantasievoll	Geist
erfinderisch	Geist
kreativ	Geist
schöpferisch	Geist
bildnerisch	Geist
bildhauerisch	Geist
plastisch	Geist
gestalterisch	Geist
künstlerisch	Geist
schauspielerisch	Geist
tänzerisch	Geist
schriftstellerisch	Geist
dichterisch	Geist
erzählerisch	Geist
narrativ	Geist
lyrisch	Geist
geistreich	Geist
weise	Geist
abgeklärt	Geist
hell	Geist
pfiffig	Geist
gescheit	Geist
gerissen	Geist
listig	Geist
trickreich	Geist
vergeistigt	Geist
alert	Geist
clever	Geist
auf Zack	Geist
gewitzt	Geist
gewieft	Geist
genial	Geist
genialisch	Geist
kongenial	Geist
erleuchtet	Geist
minderbemittelt	Geist
minderbegabt	Geist
unterentwickelt	Geist
unterbelichtet	Geist
dumm	Geist
doof	Geist
blöd	Geist
dämlich	Geist
dull	Geist
schwachsinnig	Geist
einfältig	Geist
töricht	Geist
tumb	Geist
ignorant	Geist
saudoof	Geist
saudumm	Geist
saublöd	Geist
strohdumm	Geist
strohdoof	Geist
idiotenhaft	Geist
idiotisch	Geist
tölpelhaft	Geist
tölpisch	Geist
trottelhaft	Geist
trottelig	Geist
beschränkt	Geist
behämmert	Geist
bescheuert	Geist
beknackt	Geist
belämmert	Geist
begriffsstutzig	Geist
langsam	Geist
tranig	Geist
transusig	Geist
träg	Geist
träge	Geist
aufmerksam	Geist
konzentriert	Geist
wach	Geist
wachsam	Geist
geistesgegenwärtig	Geist
zurechnungsfähig	Geist
reaktionsschnell	Geist
hellhörig	Geist
schnell	Geist
vorsichtig	Geist
unaufmerksam	Geist
unkonzentriert	Geist
verschlafen	Geist
schläfrig	Geist
gedankenverloren	Geist
gedankenlos	Geist
geistesabwesend	Geist
unzurechnungsfähig	Geist
zerstreut	Geist
vergesslich	Geist
unvorsichtig	Geist
verträumt	Geist
teilnahmslos	Geist
stumpfsinnig	Geist
wahnsinnig	Geist
irre	Geist
geisteskrank	Geist
irrsinnig	Geist
besessen	Geist
paranoid	Geist
schizoid	Geist
wissensspezifisch	Geist
denkend	Geist
rational	Geist
gedanklich	Geist
wissend	Geist
wissentlich	Geist
eingeweiht	Geist
informiert	Geist
unterrichtet	Geist
allwissend	Geist
unwissentlich	Geist
bewusst	Geist
unbewusst	Geist
erfahren	Geist
routiniert	Geist
versiert	Geist
weitgereist	Geist
weltmännisch	Geist
lebenserfahren	Geist
erprobt	Geist
bewährt	Geist
probat	Geist
altbewährt	Geist
traditionsreich	Geist
ausgereift	Geist
unausgereift	Geist
unausgegoren	Geist
unausgewogen	Geist
bewandert	Geist
beschlagen	Geist
geübt	Geist
krisenerprobt	Geist
krisenerfahren	Geist
kampferfahren	Geist
kampferprobt	Geist
unbewährt	Geist
unerprobt	Geist
fähig	Geist
befähigt	Geist
lernfähig	Geist
talentiert	Geist
begabt	Geist
unbegabt	Geist
untalentiert	Geist
hoch begabt	Geist
begnadet	Geist
musikbegabt	Geist
musikalisch	Geist
sprachbegabt	Geist
redegewandt	Geist
redebegabt	Geist
sportbegabt	Geist
sportlich	Geist
kenntnisreich	Geist
gebildet	Geist
intellektuell	Geist
gelehrt	Geist
ausgebildet	Geist
geschult	Geist
studiert	Geist
qualifiziert	Geist
überqualifiziert	Geist
unterfordert	Geist
unterqualifiziert	Geist
überfordert	Geist
kundig	Geist
kompetent	Geist
sachkundig	Geist
fachkundig	Geist
fachkompetent	Geist
belesen	Geist
unwissend	Geist
unerfahren	Geist
unfähig	Geist
kenntnislos	Geist
unkundig	Geist
unbeschlagen	Geist
inkompetent	Geist
ungebildet	Geist
bildungsfern	Geist
unausgebildet	Geist
unqualifiziert	Geist
ratlos	Geist
geschaffen	Geist
gesellschaftsspezifisch	Gesellschaft
gesellschaftlich	Gesellschaft
sozial	Gesellschaft
psychosozial	Gesellschaft
caritativ	Gesellschaft
mildtätig	Gesellschaft
wohltätig	Gesellschaft
multikulturell	Gesellschaft
pluralistisch	Gesellschaft
vielfältig	Gesellschaft
postkommunistisch	Gesellschaft
kinderreich	Gesellschaft
geburtenstark	Gesellschaft
interkulturell	Gesellschaft
aufgabenspezifisch	Gesellschaft
verantwortlich	Gesellschaft
haftbar	Gesellschaft
zuständig	Gesellschaft
befugt	Gesellschaft
federführend	Gesellschaft
führend	Gesellschaft
leitend	Gesellschaft
geschäftsführend	Gesellschaft
hochrangig	Gesellschaft
hochkarätig	Gesellschaft
eigenverantwortlich	Gesellschaft
mitverantwortlich	Gesellschaft
administrativ	Gesellschaft
verwaltungstechnisch	Gesellschaft
behördlich	Gesellschaft
tätig	Gesellschaft
pensioniert	Gesellschaft
beschäftigt	Gesellschaft
eingespannt	Gesellschaft
vielbeschäftigt	Gesellschaft
angestellt	Gesellschaft
eingestellt	Gesellschaft
verbeamtet	Gesellschaft
beamtet	Gesellschaft
verfügbar	Gesellschaft
disponibel	Gesellschaft
abrufbereit	Gesellschaft
vakant	Gesellschaft
frei	Gesellschaft
freiwerdend	Gesellschaft
lieferbar	Gesellschaft
erreichbar	Gesellschaft
kontaktierbar	Gesellschaft
ansprechbar	Gesellschaft
verhandlungsfähig	Gesellschaft
vernehmungsfähig	Gesellschaft
greifbar	Gesellschaft
diensthabend	Gesellschaft
unerreichbar	Gesellschaft
verhindert	Gesellschaft
unverfügbar	Gesellschaft
indisponibel	Gesellschaft
unansprechbar	Gesellschaft
verschwunden	Gesellschaft
unauffindbar	Gesellschaft
unaufspürbar	Gesellschaft
verschollen	Gesellschaft
vermisst	Gesellschaft
gesucht	Gesellschaft
verloren	Gesellschaft
verlegt	Gesellschaft
verloren gegangen	Gesellschaft
einsetzbar	Gesellschaft
abstellbar	Gesellschaft
vermittelbar	Gesellschaft
unvermittelbar	Gesellschaft
schwer vermittelbar	Gesellschaft
sachgebunden	Gesellschaft
sachdienlich	Gesellschaft
zweckgebunden	Gesellschaft
zweckdienlich	Gesellschaft
verwendbar	Gesellschaft
anwendbar	Gesellschaft
sachbezogen	Gesellschaft
fallbezogen	Gesellschaft
musterhaft	Gesellschaft
beispielhaft	Gesellschaft
exemplarisch	Gesellschaft
interdisziplinär	Gesellschaft
fachübergreifend	Gesellschaft
fachbezogen	Gesellschaft
fachlich	Gesellschaft
stellvertretend	Gesellschaft
ersetzend	Gesellschaft
vertretend	Gesellschaft
naturverbunden	Gesellschaft
bodenständig	Gesellschaft
rustikal	Gesellschaft
derb	Gesellschaft
deftig	Gesellschaft
zünftig	Gesellschaft
entfremdet	Gesellschaft
schichtenspezifisch	Gesellschaft
arm	Gesellschaft
verarmt	Gesellschaft
pleite	Gesellschaft
blank	Gesellschaft
abgebrannt	Gesellschaft
bankrott	Gesellschaft
zahlungsunfähig	Gesellschaft
ruiniert	Gesellschaft
erledigt	Gesellschaft
mittelständisch	Gesellschaft
proletarisch	Gesellschaft
ärmlich	Gesellschaft
bedürftig	Gesellschaft
Not leidend	Gesellschaft
reich	Gesellschaft
vermögend	Gesellschaft
wohlhabend	Gesellschaft
gutsituiert	Gesellschaft
betucht	Gesellschaft
gut betucht	Gesellschaft
zahlungskräftig	Gesellschaft
stinkreich	Gesellschaft
schwerreich	Gesellschaft
steinreich	Gesellschaft
millionenschwer	Gesellschaft
milliardenschwer	Gesellschaft
neureich	Gesellschaft
erwerbstätig	Gesellschaft
beschäftigt	Gesellschaft
berufstätig	Gesellschaft
arbeitslos	Gesellschaft
erwerbslos	Gesellschaft
bürgerlich	Gesellschaft
gutbürgerlich	Gesellschaft
kleinbürgerlich	Gesellschaft
spießerhaft	Gesellschaft
spießerisch	Gesellschaft
spießig	Gesellschaft
bieder	Gesellschaft
hausbacken	Gesellschaft
fein	Gesellschaft
vornehm	Gesellschaft
edel	Gesellschaft
nobel	Gesellschaft
adelig	Gesellschaft
aristokratisch	Gesellschaft
höfisch	Gesellschaft
feudal	Gesellschaft
feudalistisch	Gesellschaft
königlich	Gesellschaft
royal	Gesellschaft
fürstlich	Gesellschaft
kaiserlich	Gesellschaft
majestätisch	Gesellschaft
erhaben	Gesellschaft
alternativ	Gesellschaft
mächtig	Gesellschaft
einflussreich	Gesellschaft
ohnmächtig	Gesellschaft
machtlos	Gesellschaft
allmächtig	Gesellschaft
omnipotent	Gesellschaft
unbesiegbar	Gesellschaft
unschlagbar	Gesellschaft
unbezwingbar	Gesellschaft
imperial	Gesellschaft
wichtig	Gesellschaft
tonangebend	Gesellschaft
potent	Gesellschaft
institutionsspezifisch	Gesellschaft
institutionalisiert	Gesellschaft
etabliert	Gesellschaft
verbrieft	Gesellschaft
verbürgt	Gesellschaft
garantiert	Gesellschaft
verankert	Gesellschaft
öffentlich	Gesellschaft
offen	Gesellschaft
öffentlich	Gesellschaft
bekannt	Gesellschaft
publik	Gesellschaft
feierlich	Gesellschaft
zeremoniell	Gesellschaft
festlich	Gesellschaft
veröffentlicht	Gesellschaft
publiziert	Gesellschaft
bekanntgegeben	Gesellschaft
verkündet	Gesellschaft
geoutet	Gesellschaft
bekanntlich	Gesellschaft
genannt	Gesellschaft
thematisiert	Gesellschaft
erwähnt	Gesellschaft
aktenkundig	Gesellschaft
registriert	Gesellschaft
betreffend	Gesellschaft
festgehalten	Gesellschaft
dokumentiert	Gesellschaft
aufgeschrieben	Gesellschaft
notiert	Gesellschaft
fixiert	Gesellschaft
verbucht	Gesellschaft
gebucht	Gesellschaft
berechnet	Gesellschaft
gutgeschrieben	Gesellschaft
wertgestellt	Gesellschaft
nicht öffentlich	Gesellschaft
geheim	Gesellschaft
geheimgehalten	Gesellschaft
konstitutiv	Gesellschaft
verfassungsgebend	Gesellschaft
kryptisch	Gesellschaft
mysteriös	Gesellschaft
heimlich	Gesellschaft
verdeckt	Gesellschaft
vertraulich	Gesellschaft
intim	Gesellschaft
tabu	Gesellschaft
unantastbar	Gesellschaft
klammheimlich	Gesellschaft
versteckt	Gesellschaft
verborgen	Gesellschaft
latent	Gesellschaft
unterschwellig	Gesellschaft
subkutan	Gesellschaft
konspirativ	Gesellschaft
verschwörerisch	Gesellschaft
stillschweigend	Gesellschaft
unausgesprochen	Gesellschaft
diplomatisch	Gesellschaft
staatlich	Gesellschaft
rechtsstaatlich	Gesellschaft
nicht staatlich	Gesellschaft
privat	Gesellschaft
persönlich	Gesellschaft
dienstlich	Gesellschaft
dienstbezogen	Gesellschaft
beruflich	Gesellschaft
freiberuflich	Gesellschaft
freischaffend	Gesellschaft
berufsbegleitend	Gesellschaft
geschäftlich	Gesellschaft
geldlich	Gesellschaft
pekuniär	Gesellschaft
monetär	Gesellschaft
biografisch	Gesellschaft
lebensgeschichtlich	Gesellschaft
autobiografisch	Gesellschaft
amtlich	Gesellschaft
offiziell	Gesellschaft
inoffiziell	Gesellschaft
informell	Gesellschaft
unangemeldet	Gesellschaft
unangekündigt	Gesellschaft
unangesagt	Gesellschaft
formell	Gesellschaft
eingetragen	Gesellschaft
eingeschrieben	Gesellschaft
registriert	Gesellschaft
anerkannt	Gesellschaft
ausgewiesen	Gesellschaft
erfasst	Gesellschaft
angemeldet	Gesellschaft
angekündigt	Gesellschaft
angesagt	Gesellschaft
ehrenamtlich	Gesellschaft
hauptamtlich	Gesellschaft
hauptberuflich	Gesellschaft
nebenamtlich	Gesellschaft
nebenberuflich	Gesellschaft
zivil	Gesellschaft
militärisch	Gesellschaft
paramilitärisch	Gesellschaft
kirchlich	Gesellschaft
schulisch	Gesellschaft
gymnasial	Gesellschaft
geistlich	Gesellschaft
spirituell	Gesellschaft
politisch	Gesellschaft
demokratisch	Gesellschaft
basisdemokratisch	Gesellschaft
umweltpolitisch	Gesellschaft
verbraucherschutzpolitisch	Gesellschaft
gesellschaftspolitisch	Gesellschaft
medienpolitisch	Gesellschaft
kapitalistisch	Gesellschaft
gesundheitspolitisch	Gesellschaft
innerparteilich	Gesellschaft
überparteilich	Gesellschaft
ordnungspolitisch	Gesellschaft
realpolitisch	Gesellschaft
bevölkerungspolitisch	Gesellschaft
sicherheitspolitisch	Gesellschaft
verkehrspolitisch	Gesellschaft
parteipolitisch	Gesellschaft
parteilich	Gesellschaft
gaullistisch	Gesellschaft
kommunalpolitisch	Gesellschaft
lokalpolitisch	Gesellschaft
landespolitisch	Gesellschaft
bundespolitisch	Gesellschaft
beschäftigungspolitisch	Gesellschaft
arbeitsmarktpolitisch	Gesellschaft
bildungspolitisch	Gesellschaft
rechtspolitisch	Gesellschaft
energiepolitisch	Gesellschaft
finanzpolitisch	Gesellschaft
geldpolitisch	Gesellschaft
tarifpolitisch	Gesellschaft
lohnpolitisch	Gesellschaft
steuerpolitisch	Gesellschaft
familienpolitisch	Gesellschaft
frauenpolitisch	Gesellschaft
feministisch	Gesellschaft
frauenbewegt	Gesellschaft
sozialpolitisch	Gesellschaft
verteidigungspolitisch	Gesellschaft
weltpolitisch	Gesellschaft
wissenschaftspolitisch	Gesellschaft
wohnungsbaupolitisch	Gesellschaft
wohnungspolitisch	Gesellschaft
rüstungspolitisch	Gesellschaft
wirtschaftspolitisch	Gesellschaft
einwanderungspolitisch	Gesellschaft
innenpolitisch	Gesellschaft
außenpolitisch	Gesellschaft
friedenspolitisch	Gesellschaft
friedenserhaltend	Gesellschaft
kulturpolitisch	Gesellschaft
sozialdemokratisch	Gesellschaft
christdemokratisch	Gesellschaft
christlich-demokratisch	Gesellschaft
christsozial	Gesellschaft
christlich-sozial	Gesellschaft
politisch orientiert	Gesellschaft
unpolitisch	Gesellschaft
link	Gesellschaft
linksorientiert	Gesellschaft
recht	Gesellschaft
rechtsorientiert	Gesellschaft
rechtskonservativ	Gesellschaft
rechtsliberal	Gesellschaft
liberal	Gesellschaft
liberaldemokratisch	Gesellschaft
linksliberal	Gesellschaft
sozialliberal	Gesellschaft
pazifistisch	Gesellschaft
friedensbewegt	Gesellschaft
zionistisch	Gesellschaft
antizionistisch	Gesellschaft
monarchisch	Gesellschaft
zaristisch	Gesellschaft
patriarchalisch	Gesellschaft
populistisch	Gesellschaft
volksnah	Gesellschaft
revolutionär	Gesellschaft
terroristisch	Gesellschaft
diktatorisch	Gesellschaft
willkürlich	Gesellschaft
separatistisch	Gesellschaft
undemokratisch	Gesellschaft
anarchisch	Gesellschaft
anarchistisch	Gesellschaft
kommunistisch	Gesellschaft
marxistisch	Gesellschaft
leninistisch	Gesellschaft
stalinistisch	Gesellschaft
maoistisch	Gesellschaft
sozialistisch	Gesellschaft
faschistisch	Gesellschaft
antifaschistisch	Gesellschaft
republikanisch	Gesellschaft
nationalsozialistisch	Gesellschaft
neonazistisch	Gesellschaft
neofaschistisch	Gesellschaft
nationalistisch	Gesellschaft
chauvinistisch	Gesellschaft
rot	Gesellschaft
schwarz	Gesellschaft
grün	Gesellschaft
rot-grün	Gesellschaft
christliberal	Gesellschaft
schwarz-gelb	Gesellschaft
heimatverbunden	Gesellschaft
heimatlos	Gesellschaft
vaterlandslos	Gesellschaft
volkstümlich	Gesellschaft
heimatlich	Gesellschaft
verwurzelt	Gesellschaft
verankert	Gesellschaft
entwurzelt	Gesellschaft
vereinbart	Gesellschaft
festgelegt	Gesellschaft
unverrückbar	Gesellschaft
fixiert	Gesellschaft
fix	Gesellschaft
definiert	Gesellschaft
ausbuchstabiert	Gesellschaft
vertraglich	Gesellschaft
vorgeschrieben	Gesellschaft
reglementiert	Gesellschaft
reguliert	Gesellschaft
kontrolliert	Gesellschaft
festgefahren	Gesellschaft
eingefahren	Gesellschaft
eingespielt	Gesellschaft
abgemacht	Gesellschaft
ausgehandelt	Gesellschaft
abgesprochen	Gesellschaft
ausgemacht	Gesellschaft
gewählt	Gesellschaft
erwählt	Gesellschaft
ständisch	Gesellschaft
volljährig	Gesellschaft
mündig	Gesellschaft
minderjährig	Gesellschaft
unmündig	Gesellschaft
erwachsen	Gesellschaft
heranwachsend	Gesellschaft
halbwüchsig	Gesellschaft
halbstark	Gesellschaft
reif	Gesellschaft
unreif	Gesellschaft
ehelich	Gesellschaft
nicht ehelich	Gesellschaft
unehelich	Gesellschaft
unverheiratet	Gesellschaft
ledig	Gesellschaft
verehelicht	Gesellschaft
verheiratet	Gesellschaft
verwitwet	Gesellschaft
geschieden	Gesellschaft
getrennt	Gesellschaft
getrennt lebend	Gesellschaft
liiert	Gesellschaft
gebunden	Gesellschaft
ungebunden	Gesellschaft
alleinstehend	Gesellschaft
alleinerziehend	Gesellschaft
religionsspezifisch	Gesellschaft
metaphysisch	Gesellschaft
transzendent	Gesellschaft
jenseitig	Gesellschaft
materiell	Gesellschaft
weltlich	Gesellschaft
profan	Gesellschaft
diesseitig	Gesellschaft
ideell	Gesellschaft
immateriell	Gesellschaft
säkular	Gesellschaft
säkularisiert	Gesellschaft
verweltlicht	Gesellschaft
gläubig	Gesellschaft
bekennend	Gesellschaft
gottesfürchtig	Gesellschaft
gottesgläubig	Gesellschaft
fromm	Gesellschaft
religiös	Gesellschaft
buddhistisch	Gesellschaft
taoistisch	Gesellschaft
konfuzianistisch	Gesellschaft
hinduistisch	Gesellschaft
christlich	Gesellschaft
ökumenisch	Gesellschaft
katholisch	Gesellschaft
schwarz	Gesellschaft
evangelisch	Gesellschaft
protestantisch	Gesellschaft
lutherisch	Gesellschaft
evangelisch-lutherisch	Gesellschaft
evangelisch-reformiert	Gesellschaft
jüdisch	Gesellschaft
islamisch	Gesellschaft
moslemisch	Gesellschaft
muslimisch	Gesellschaft
mohammedanisch	Gesellschaft
schiitisch	Gesellschaft
ungläubig	Gesellschaft
atheistisch	Gesellschaft
agnostisch	Gesellschaft
heidnisch	Gesellschaft
heilig	Gesellschaft
sakral	Gesellschaft
geweiht	Gesellschaft
sakrosankt	Gesellschaft
hochheilig	Gesellschaft
unantastbar	Gesellschaft
kultisch	Gesellschaft
rituell	Gesellschaft
selig	Gesellschaft
göttlich	Gesellschaft
ideologisch	Gesellschaft
dogmatisch	Gesellschaft
fundamentalistisch	Gesellschaft
technokratisch	Gesellschaft
bürokratisch	Gesellschaft
fanatisch	Gesellschaft
extremistisch	Gesellschaft
exzessiv	Gesellschaft
ausschweifend	Gesellschaft
fixiert	Gesellschaft
besessen	Gesellschaft
undogmatisch	Gesellschaft
unbürokratisch	Gesellschaft
rassenspezifisch	Gesellschaft
ethnisch	Gesellschaft
weiß	Gesellschaft
farbig	Gesellschaft
schwarz	Gesellschaft
dunkelhäutig	Gesellschaft
afro-amerikanisch	Gesellschaft
gelb	Gesellschaft
rot	Gesellschaft
indianisch	Gesellschaft
länderspezifisch	Gesellschaft
außereuropäisch	Gesellschaft
nicht europäisch	Gesellschaft
europäisch	Gesellschaft
innereuropäisch	Gesellschaft
gesamteuropäisch	Gesellschaft
südeuropäisch	Gesellschaft
südländisch	Gesellschaft
mediterran	Gesellschaft
französisch	Gesellschaft
nordfranzösisch	Gesellschaft
westfranzösisch	Gesellschaft
südfranzösisch	Gesellschaft
mittelfranzösisch	Gesellschaft
zentralfranzösisch	Gesellschaft
ostfranzösisch	Gesellschaft
elsässisch	Gesellschaft
italienisch	Gesellschaft
norditalienisch	Gesellschaft
oberitalienisch	Gesellschaft
süditalienisch	Gesellschaft
toskanisch	Gesellschaft
umbrisch	Gesellschaft
ligurisch	Gesellschaft
lombardisch	Gesellschaft
abruzzisch	Gesellschaft
kalabrisch	Gesellschaft
venetianisch	Gesellschaft
venezianisch	Gesellschaft
sizilianisch	Gesellschaft
sardinisch	Gesellschaft
trentinisch	Gesellschaft
piemontisch	Gesellschaft
friaulisch	Gesellschaft
apulisch	Gesellschaft
etruskisch	Gesellschaft
römisch	Gesellschaft
spanisch	Gesellschaft
nordspanisch	Gesellschaft
südspanisch	Gesellschaft
zentralspanisch	Gesellschaft
mittelspanisch	Gesellschaft
westspanisch	Gesellschaft
ostspanisch	Gesellschaft
andalusisch	Gesellschaft
kanarisch	Gesellschaft
balearisch	Gesellschaft
madrilenisch	Gesellschaft
aragonisch	Gesellschaft
asturisch	Gesellschaft
baskisch	Gesellschaft
extremadurisch	Gesellschaft
galizisch	Gesellschaft
kantabrisch	Gesellschaft
kastilisch	Gesellschaft
katalanisch	Gesellschaft
griechisch	Gesellschaft
altgriechisch	Gesellschaft
portugiesisch	Gesellschaft
holländisch	Gesellschaft
niederländisch	Gesellschaft
belgisch	Gesellschaft
luxemburgisch	Gesellschaft
österreichisch	Gesellschaft
österreicherisch	Gesellschaft
niederösterreichisch	Gesellschaft
oberösterreichisch	Gesellschaft
steirisch	Gesellschaft
schweizerisch	Gesellschaft
eidgenössisch	Gesellschaft
helvetisch	Gesellschaft
hanseatisch	Gesellschaft
hamburgisch	Gesellschaft
deutsch	Gesellschaft
innerdeutsch	Gesellschaft
gesamtdeutsch	Gesellschaft
liechtensteinisch	Gesellschaft
germanisch	Gesellschaft
alemannisch	Gesellschaft
keltisch	Gesellschaft
ostdeutsch	Gesellschaft
westdeutsch	Gesellschaft
süddeutsch	Gesellschaft
norddeutsch	Gesellschaft
niederdeutsch	Gesellschaft
plattdeutsch	Gesellschaft
bundesdeutsch	Gesellschaft
schwäbisch	Gesellschaft
hessisch	Gesellschaft
nordhessisch	Gesellschaft
mittelhessisch	Gesellschaft
südhessisch	Gesellschaft
sächsisch	Gesellschaft
thüringisch	Gesellschaft
niedersächsisch	Gesellschaft
ostfriesisch	Gesellschaft
mecklenburgisch	Gesellschaft
fränkisch	Gesellschaft
mittelfränkisch	Gesellschaft
oberfränkisch	Gesellschaft
niederfränkisch	Gesellschaft
unterfränkisch	Gesellschaft
bayerisch	Gesellschaft
oberbayerisch	Gesellschaft
niederbayerisch	Gesellschaft
nordbayerisch	Gesellschaft
ostbayerisch	Gesellschaft
südbayerisch	Gesellschaft
oberpfälzisch	Gesellschaft
pfälzisch	Gesellschaft
westfälisch	Gesellschaft
nordrhein-westfälisch	Gesellschaft
baden-württembergisch	Gesellschaft
badisch	Gesellschaft
württembergisch	Gesellschaft
rheinland-pfälzisch	Gesellschaft
rheinländisch	Gesellschaft
rheinisch	Gesellschaft
linksrheinisch	Gesellschaft
rechtsrheinisch	Gesellschaft
brandenburgisch	Gesellschaft
schleswig-holsteinisch	Gesellschaft
holsteinisch	Gesellschaft
saarländisch	Gesellschaft
niederrheinisch	Gesellschaft
preußisch	Gesellschaft
westeuropäisch	Gesellschaft
mitteleuropäisch	Gesellschaft
zentraleuropäisch	Gesellschaft
britisch	Gesellschaft
großbritannisch	Gesellschaft
flämisch	Gesellschaft
englisch	Gesellschaft
nordenglisch	Gesellschaft
südenglisch	Gesellschaft
schottisch	Gesellschaft
walisisch	Gesellschaft
nordirisch	Gesellschaft
irisch	Gesellschaft
südosteuropäisch	Gesellschaft
serbisch	Gesellschaft
bosnisch	Gesellschaft
ostbosnisch	Gesellschaft
kroatisch	Gesellschaft
jugoslawisch	Gesellschaft
bulgarisch	Gesellschaft
rumänisch	Gesellschaft
albanisch	Gesellschaft
zypriotisch	Gesellschaft
mazedonisch	Gesellschaft
slowakisch	Gesellschaft
ukrainisch	Gesellschaft
georgisch	Gesellschaft
tschetschenisch	Gesellschaft
osteuropäisch	Gesellschaft
slawisch	Gesellschaft
sorbisch	Gesellschaft
litauisch	Gesellschaft
lettisch	Gesellschaft
estnisch	Gesellschaft
baltisch	Gesellschaft
polnisch	Gesellschaft
tschechisch	Gesellschaft
böhmisch	Gesellschaft
mährisch	Gesellschaft
schlesisch	Gesellschaft
ostpreußisch	Gesellschaft
tschechoslowakisch	Gesellschaft
ungarisch	Gesellschaft
slowenisch	Gesellschaft
zentralasiatisch	Gesellschaft
usbekisch	Gesellschaft
kasachisch	Gesellschaft
kirgisisch	Gesellschaft
turkmenisch	Gesellschaft
tadschikisch	Gesellschaft
armenisch	Gesellschaft
aserbaidschanisch	Gesellschaft
moldawisch	Gesellschaft
amerikanisch	Gesellschaft
nordamerikanisch	Gesellschaft
US-amerikanisch	Gesellschaft
texanisch	Gesellschaft
alabamisch	Gesellschaft
alaskisch	Gesellschaft
nevadisch	Gesellschaft
kalifornisch	Gesellschaft
louisianisch	Gesellschaft
asiatisch	Gesellschaft
kanadisch	Gesellschaft
eurasisch	Gesellschaft
afghanisch	Gesellschaft
türkisch	Gesellschaft
osmanisch	Gesellschaft
kurdisch	Gesellschaft
ostasiatisch	Gesellschaft
fernöstlich	Gesellschaft
nahöstlich	Gesellschaft
israelitisch	Gesellschaft
israelisch	Gesellschaft
chinesisch	Gesellschaft
nordchinesisch	Gesellschaft
südchinesisch	Gesellschaft
tibetisch	Gesellschaft
japanisch	Gesellschaft
koreanisch	Gesellschaft
nordkoreanisch	Gesellschaft
südkoreanisch	Gesellschaft
thailändisch	Gesellschaft
vietnamesisch	Gesellschaft
kambodschanisch	Gesellschaft
malaysisch	Gesellschaft
maledivisch	Gesellschaft
kombodschanisch	Gesellschaft
laotisch	Gesellschaft
südostasiatisch	Gesellschaft
südasiatisch	Gesellschaft
arabisch	Gesellschaft
kuwaitisch	Gesellschaft
irakisch	Gesellschaft
persisch	Gesellschaft
iranisch	Gesellschaft
saudi-arabisch	Gesellschaft
saudiarabisch	Gesellschaft
saudisch	Gesellschaft
jordanisch	Gesellschaft
syrisch	Gesellschaft
libanesisch	Gesellschaft
jemenitisch	Gesellschaft
südjemenitisch	Gesellschaft
palästinensisch	Gesellschaft
indisch	Gesellschaft
philippinisch	Gesellschaft
tamilisch	Gesellschaft
pakistanisch	Gesellschaft
mongolisch	Gesellschaft
nepalesisch	Gesellschaft
bhutanesisch	Gesellschaft
australisch	Gesellschaft
polynesisch	Gesellschaft
neuseeländisch	Gesellschaft
russisch	Gesellschaft
weißrussisch	Gesellschaft
sibirisch	Gesellschaft
indonesisch	Gesellschaft
sowjetisch	Gesellschaft
lateinamerikanisch	Gesellschaft
südamerikanisch	Gesellschaft
mittelamerikanisch	Gesellschaft
mexikanisch	Gesellschaft
südmexikanisch	Gesellschaft
jamaikanisch	Gesellschaft
haitianisch	Gesellschaft
puertoricanisch	Gesellschaft
kubanisch	Gesellschaft
karibisch	Gesellschaft
pazifisch	Gesellschaft
peruanisch	Gesellschaft
bolivianisch	Gesellschaft
argentinisch	Gesellschaft
chilenisch	Gesellschaft
brasilianisch	Gesellschaft
venezuelisch	Gesellschaft
venezolanisch	Gesellschaft
kolumbianisch	Gesellschaft
guayanisch	Gesellschaft
surinamesisch	Gesellschaft
paraguayanisch	Gesellschaft
uruguayanisch	Gesellschaft
ecuadorianisch	Gesellschaft
nordeuropäisch	Gesellschaft
nordisch	Gesellschaft
skandinavisch	Gesellschaft
isländisch	Gesellschaft
färöisch	Gesellschaft
grönländisch	Gesellschaft
norwegisch	Gesellschaft
finnisch	Gesellschaft
schwedisch	Gesellschaft
dänisch	Gesellschaft
afrikanisch	Gesellschaft
zentralafrikanisch	Gesellschaft
burundisch	Gesellschaft
ruandisch	Gesellschaft
nigerianisch	Gesellschaft
ugandisch	Gesellschaft
tansanisch	Gesellschaft
zairisch	Gesellschaft
nordafrikanisch	Gesellschaft
sudanesisch	Gesellschaft
tunesisch	Gesellschaft
algerisch	Gesellschaft
ägyptisch	Gesellschaft
altägyptisch	Gesellschaft
marokkanisch	Gesellschaft
libysch	Gesellschaft
südafrikanisch	Gesellschaft
äthiopisch	Gesellschaft
angolanisch	Gesellschaft
ostafrikanisch	Gesellschaft
kenianisch	Gesellschaft
eritreisch	Gesellschaft
somalisch	Gesellschaft
djibutisch	Gesellschaft
westafrikanisch	Gesellschaft
senegalesisch	Gesellschaft
liberianisch	Gesellschaft
namibisch	Gesellschaft
ghanaisch	Gesellschaft
beninisch	Gesellschaft
gambisch	Gesellschaft
guineisch	Gesellschaft
antarktisch	Gesellschaft
regionalspezifisch	Gesellschaft
metropolitan	Gesellschaft
hauptstädtisch	Gesellschaft
kosmopolitisch	Gesellschaft
gemeindlich	Gesellschaft
regional	Gesellschaft
überregional	Gesellschaft
städtisch	Gesellschaft
urban	Gesellschaft
innerstädtisch	Gesellschaft
großstädtisch	Gesellschaft
ländlich	Gesellschaft
dörflich	Gesellschaft
provinziell	Gesellschaft
örtlich	Gesellschaft
bundesweit	Gesellschaft
landesweit	Gesellschaft
international	Gesellschaft
multinational	Gesellschaft
insular	Gesellschaft
alpin	Gesellschaft
romanisch	Gesellschaft
iberisch	Gesellschaft
peninsular	Gesellschaft
peninsularisch	Gesellschaft
äquatorial	Gesellschaft
kontinental	Gesellschaft
okzidental	Gesellschaft
okzidentalisch	Gesellschaft
abendländisch	Gesellschaft
oriental	Gesellschaft
morgenländisch	Gesellschaft
orientalisch	Gesellschaft
zonal	Gesellschaft
zonar	Gesellschaft
polar	Gesellschaft
atlantisch	Gesellschaft
transatlantisch	Gesellschaft
sprachbezogen	Gesellschaft
sprachlich	Gesellschaft
einsprachig	Gesellschaft
mehrsprachig	Gesellschaft
polylingual	Gesellschaft
polyglott	Gesellschaft
multilingual	Gesellschaft
vielsprachig	Gesellschaft
zweisprachig	Gesellschaft
bilingual	Gesellschaft
fachsprachlich	Gesellschaft
fachterminologisch	Gesellschaft
hochsprachlich	Gesellschaft
standardsprachlich	Gesellschaft
umgangssprachlich	Gesellschaft
alltagssprachlich	Gesellschaft
mundartlich	Gesellschaft
dialektal	Gesellschaft
regionalsprachlich	Gesellschaft
sprachspezifisch	Gesellschaft
deutschsprachig	Gesellschaft
hebräisch	Gesellschaft
jiddisch	Gesellschaft
welsch	Gesellschaft
gälisch	Gesellschaft
ossetisch	Gesellschaft
neudeutsch	Gesellschaft
denglisch	Gesellschaft
englischsprachig	Gesellschaft
französischsprachig	Gesellschaft
spanischsprachig	Gesellschaft
russischsprachig	Gesellschaft
stilistisch	Gesellschaft
humoristisch	Gesellschaft
satirisch	Gesellschaft
polemisch	Gesellschaft
reißerisch	Gesellschaft
sensationsheischend	Gesellschaft
rhetorisch	Gesellschaft
redetechnisch	Gesellschaft
rednerisch	Gesellschaft
römisch-katholisch	Gesellschaft
deutschfranzösisch	Gesellschaft
lateinisch	Gesellschaft
sogenannt	Gesellschaft
öffentlich-rechtlich	Gesellschaft
US-amerikanisch	Gesellschaft
amtierend	Gesellschaft
bemannt	Gesellschaft
erschienen	Gesellschaft
ausgewählt	Gesellschaft
geschrieben	Gesellschaft
verfasst	Gesellschaft
evangelisch-lutherisch	Gesellschaft
stadtartig	Gesellschaft
althochdeutsch	Gesellschaft
mittelhochdeutsch	Gesellschaft
mitteldeutsch	Gesellschaft
hochdeutsch	Gesellschaft
deutschnational	Gesellschaft
sudetendeutsch	Gesellschaft
südwestdeutsch	Gesellschaft
kleinasiatisch	Gesellschaft
kleinstädtisch	Gesellschaft
kleinkariert	Gesellschaft
baltendeutsch	Gesellschaft
karpatendeutsch	Gesellschaft
reichsdeutsch	Gesellschaft
großbürgerlich	Gesellschaft
großdeutsch	Gesellschaft
großpolnisch	Gesellschaft
großmährisch	Gesellschaft
kleinadelig	Gesellschaft
kleinadlig	Gesellschaft
kanadischdeutsch	Gesellschaft
nicht deutschsprachig	Gesellschaft
französischdeutsch	Gesellschaft
italienischdeutsch	Gesellschaft
lateinischdeutsch	Gesellschaft
deutschaustralisch	Gesellschaft
deutschchristlich	Gesellschaft
schwedischdeutsch	Gesellschaft
deutschkroatisch	Gesellschaft
deutschamerikanisch	Gesellschaft
nicht christlich	Gesellschaft
nicht jüdisch	Gesellschaft
nicht deutsch	Gesellschaft
nicht kommunistisch	Gesellschaft
nicht englischsprachig	Gesellschaft
nicht militärisch	Gesellschaft
nicht europäisch	Gesellschaft
nicht mohammedanisch	Gesellschaft
nicht moslemisch	Gesellschaft
nicht islamisch	Gesellschaft
nicht muslimisch	Gesellschaft
nicht religiös	Gesellschaft
nicht katholisch	Gesellschaft
nicht angemeldet	Gesellschaft
nicht amerikanisch	Gesellschaft
nicht amtlich	Gesellschaft
nicht leitend	Gesellschaft
nicht russisch	Gesellschaft
nicht kirchlich	Gesellschaft
nicht lateinisch	Gesellschaft
nicht sozialistisch	Gesellschaft
nicht griechisch	Gesellschaft
nicht chinesisch	Gesellschaft
nicht arabisch	Gesellschaft
nicht sprachlich	Gesellschaft
nicht offiziell	Gesellschaft
nicht japanisch	Gesellschaft
nicht serbisch	Gesellschaft
nicht römisch	Gesellschaft
nicht alemannisch	Gesellschaft
nicht türkisch	Gesellschaft
nicht italienisch	Gesellschaft
nicht englisch	Gesellschaft
nicht italienisch	Gesellschaft
nicht preußisch	Gesellschaft
indoeuropäisch	Gesellschaft
nicht indogermanisch	Gesellschaft
nicht königlich	Gesellschaft
nicht beamtet	Gesellschaft
nicht britisch	Gesellschaft
nicht monetär	Gesellschaft
nicht adelig	Gesellschaft
nicht materiell	Gesellschaft
indogermanisch	Gesellschaft
okkult	Gesellschaft
orthodox	Gesellschaft
nicht orthodox	Gesellschaft
nicht marxistisch	Gesellschaft
hochstehend	Gesellschaft
körperspezifisch	Koerper
anatomisch	Koerper
belebtheitsspezifisch	Koerper
tot	Koerper
mausetot	Koerper
leblos	Koerper
entseelt	Koerper
verstorben	Koerper
verblichen	Koerper
verschieden	Koerper
gestorben	Koerper
lebendig	Koerper
lebend	Koerper
belebt	Koerper
konstitutionsspezifisch	Koerper
stark	Koerper
kräftig	Koerper
zäh	Koerper
widerstandsfähig	Koerper
hart	Koerper
abgehärtet	Koerper
unverwüstlich	Koerper
robust	Koerper
vital	Koerper
belastbar	Koerper
kraftvoll	Koerper
stabil	Koerper
stramm	Koerper
kernig	Koerper
trainiert	Koerper
durchtrainiert	Koerper
fit	Koerper
konditionsstark	Koerper
sportlich	Koerper
sportiv	Koerper
athletisch	Koerper
schwach	Koerper
kraftlos	Koerper
untrainiert	Koerper
unsportlich	Koerper
schwächlich	Koerper
mickerig	Koerper
memmenhaft	Koerper
schlapp	Koerper
schlaff	Koerper
gebrechlich	Koerper
morbide	Koerper
hinfällig	Koerper
anfällig	Koerper
zart	Koerper
krankheitsspezifisch	Koerper
gesund	Koerper
kerngesund	Koerper
resistent	Koerper
immun	Koerper
quietschfidel	Koerper
klar	Koerper
rüstig	Koerper
heil	Koerper
clean	Koerper
unverletzt	Koerper
unversehrt	Koerper
verheilt	Koerper
gesundet	Koerper
genesen	Koerper
geistesklar	Koerper
klar	Koerper
geistesgegenwärtig	Koerper
krank	Koerper
ungesund	Koerper
leidend	Koerper
krankhaft	Koerper
pathologisch	Koerper
mondsüchtig	Koerper
sonnambul	Koerper
geplagt	Koerper
geschunden	Koerper
gequält	Koerper
kränklich	Koerper
kränkelnd	Koerper
verletzt	Koerper
verwundet	Koerper
schwerverletzt	Koerper
schwerverwundet	Koerper
krankenhausreif	Koerper
krebskrank	Koerper
herzkrank	Koerper
zuckerkrank	Koerper
gallenkrank	Koerper
leberkrank	Koerper
nierenkrank	Koerper
drüsenkrank	Koerper
magenkrank	Koerper
aidskrank	Koerper
lungenkrank	Koerper
blutig	Koerper
blutend	Koerper
lädiert	Koerper
blessiert	Koerper
eitrig	Koerper
eiternd	Koerper
vereitert	Koerper
wund	Koerper
entzündet	Koerper
verschorft	Koerper
erkältet	Koerper
verschnupft	Koerper
verschleimt	Koerper
anämisch	Koerper
blutarm	Koerper
tuberkular	Koerper
knotig	Koerper
missgebildet	Koerper
beeinträchtigt	Koerper
körperlich beeinträchtigt	Koerper
kurzsichtig	Koerper
weitsichtig	Koerper
körperbehindert	Koerper
körperlich behindert	Koerper
versehrt	Koerper
geistig behindert	Koerper
geisteskrank	Koerper
seelisch behindert	Koerper
psychisch krank	Koerper
depressiv	Koerper
manisch	Koerper
manisch-depressiv	Koerper
schizophren	Koerper
persönlichkeitsgespalten	Koerper
psychopathisch	Koerper
schizoid	Koerper
paranoid	Koerper
neurotisch	Koerper
zwanghaft	Koerper
zwangsgestört	Koerper
behindert	Koerper
blind	Koerper
taub	Koerper
lahm	Koerper
stumm	Koerper
taubstumm	Koerper
schlecht	Koerper
übel	Koerper
schwindlig	Koerper
mau	Koerper
flau	Koerper
matt	Koerper
magersüchtig	Koerper
heiser	Koerper
rau	Koerper
belegt	Koerper
krüppelhaft	Koerper
krüppelig	Koerper
verkrüppelt	Koerper
gestört	Koerper
verhaltensgestört	Koerper
geistesgestört	Koerper
verrückt	Koerper
verwirrt	Koerper
dement	Koerper
durcheinander	Koerper
ohnmächtig	Koerper
besinnungslos	Koerper
bewusstlos	Koerper
komatös	Koerper
körpergefühlsspezifisch	Koerper
hungrig	Koerper
ausgehungert	Koerper
durstig	Koerper
betrunken	Koerper
trunken	Koerper
angeheitert	Koerper
angetrunken	Koerper
angesäuselt	Koerper
beschwipst	Koerper
angesoffen	Koerper
blau	Koerper
schicker	Koerper
besoffen	Koerper
fett	Koerper
stramm	Koerper
vollstramm	Koerper
volltrunken	Koerper
nüchtern	Koerper
berauscht	Koerper
dicht	Koerper
bekifft	Koerper
stoned	Koerper
high	Koerper
angetörnt	Koerper
angeturnt	Koerper
versoffen	Koerper
heißhungrig	Koerper
gefräßig	Koerper
verfressen	Koerper
satt	Koerper
gesättigt	Koerper
übersättigt	Koerper
pappsatt	Koerper
voll	Koerper
vollgefressen	Koerper
voll gestopft	Koerper
müde	Koerper
todmüde	Koerper
schläfrig	Koerper
verschlafen	Koerper
erschöpft	Koerper
ausgebrannt	Koerper
ausgepumpt	Koerper
ausgelaugt	Koerper
entkräftet	Koerper
abgespannt	Koerper
mitgenommen	Koerper
resigniert	Koerper
frustriert	Koerper
fertig	Koerper
groggy	Koerper
ausgepowert	Koerper
erholungsbedürftig	Koerper
urlaubsreif	Koerper
phlegmatisch	Koerper
faul	Koerper
lebhaft	Koerper
wach	Koerper
hellwach	Koerper
überdreht	Koerper
aufgedreht	Koerper
aufgekratzt	Koerper
überspannt	Koerper
munter	Koerper
putzmunter	Koerper
aufgeweckt	Koerper
lebendig	Koerper
quicklebendig	Koerper
gierig	Koerper
unersättlich	Koerper
triebhaft	Koerper
libidonös	Koerper
lasziv	Koerper
begierig	Koerper
begehrlich	Koerper
heiß	Koerper
geil	Koerper
lüstern	Koerper
sexhungrig	Koerper
sexgierig	Koerper
schwanzgesteuert	Koerper
kalt	Koerper
frigid	Koerper
frigide	Koerper
geschlechtsspezifisch	Koerper
weiblich	Koerper
feminin	Koerper
männlich	Koerper
maskulin	Koerper
aussehensspezifisch	Koerper
nackt	Koerper
bloß	Koerper
unbekleidet	Koerper
entblößt	Koerper
unverhüllt	Koerper
bekleidet	Koerper
gekleidet	Koerper
livriert	Koerper
uniformiert	Koerper
befrackt	Koerper
splitternackt	Koerper
splitterfasernackt	Koerper
pudelnackt	Koerper
kniefrei	Koerper
armfrei	Koerper
schulterfrei	Koerper
beinfrei	Koerper
rückenfrei	Koerper
bauchfrei	Koerper
schön	Koerper
wunderschön	Koerper
hübsch	Koerper
wohlgeformt	Koerper
griffig	Koerper
bildhübsch	Koerper
attraktiv	Koerper
anziehend	Koerper
rassig	Koerper
apart	Koerper
sinnlich	Koerper
fein geschnitten	Koerper
fein	Koerper
ansehnlich	Koerper
vorzeigbar	Koerper
sexy	Koerper
geil	Koerper
scharf	Koerper
anmutig	Koerper
graziös	Koerper
hässlich	Koerper
unansehnlich	Koerper
unappetitlich	Koerper
ungepflegt	Koerper
schmuddelig	Koerper
fettig	Koerper
strähnig	Koerper
ölig	Koerper
verlottert	Koerper
verkommen	Koerper
vergammelt	Koerper
verlumpt	Koerper
verwahrlost	Koerper
verschwitzt	Koerper
lumpig	Koerper
gammlig	Koerper
gammelig	Koerper
abgerissen	Koerper
gepflegt	Koerper
adrett	Koerper
appetitlich	Koerper
unattraktiv	Koerper
unscheinbar	Koerper
verbraucht	Koerper
verlebt	Koerper
potthässlich	Koerper
ästhetisch	Koerper
ansprechend	Koerper
dekorativ	Koerper
schmuck	Koerper
stilvoll	Koerper
geschmackvoll	Koerper
formvollendet	Koerper
formschön	Koerper
unästhetisch	Koerper
plump	Koerper
unförmig	Koerper
verwachsen	Koerper
bucklig	Koerper
entstellt	Koerper
pickelig	Koerper
deformiert	Koerper
verformt	Koerper
zerbeult	Koerper
dick	Koerper
übergewichtig	Koerper
schwergewichtig	Koerper
wohlbeleibt	Koerper
fleischig	Koerper
umfangreich	Koerper
vollschlank	Koerper
füllig	Koerper
fett	Koerper
fettleibig	Koerper
feist	Koerper
bullig	Koerper
bullerig	Koerper
stattlich	Koerper
stämmig	Koerper
barock	Koerper
matronenhaft	Koerper
aufgedunsen	Koerper
aufgetrieben	Koerper
korpulent	Koerper
voluminös	Koerper
beleibt	Koerper
rund	Koerper
rundlich	Koerper
mollig	Koerper
dicklich	Koerper
üppig	Koerper
vollbusig	Koerper
prall	Koerper
untersetzt	Koerper
dickwanstig	Koerper
dickbäuchig	Koerper
massig	Koerper
kompakt	Koerper
ultrakompakt	Koerper
breit	Koerper
dünn	Koerper
untergewichtig	Koerper
leichtgewichtig	Koerper
schmal	Koerper
mager	Koerper
hager	Koerper
knochig	Koerper
dürr	Koerper
schmächtig	Koerper
rappeldürr	Koerper
klapperdürr	Koerper
spindeldürr	Koerper
klapprig	Koerper
abgemagert	Koerper
abgemergelt	Koerper
ausgemergelt	Koerper
abgezehrt	Koerper
unterernährt	Koerper
schlank	Koerper
rank	Koerper
gertenschlank	Koerper
rosig	Koerper
blühend	Koerper
sommersprossig	Koerper
pausbäckig	Koerper
blond	Koerper
braun	Koerper
braunhäutig	Koerper
weißhäutig	Koerper
hellhäutig	Koerper
wasserstoffblond	Koerper
weißblond	Koerper
hellblond	Koerper
rotblond	Koerper
rötlich-blond	Koerper
aschblond	Koerper
dunkelblond	Koerper
silberblond	Koerper
goldblond	Koerper
dunkelhaarig	Koerper
brünett	Koerper
braunhaarig	Koerper
kastanienbraun	Koerper
rotbraun	Koerper
dunkelbraun	Koerper
schwarzbraun	Koerper
kahl	Koerper
glatzköpfig	Koerper
kahlköpfig	Koerper
behaart	Koerper
haarig	Koerper
bärtig	Koerper
vollbärtig	Koerper
unbehaart	Koerper
haarlos	Koerper
rothaarig	Koerper
schwarzhaarig	Koerper
blauschwarz	Koerper
grau	Koerper
grauhaarig	Koerper
graumeliert	Koerper
lockig	Koerper
kraus	Koerper
langhaarig	Koerper
langmähnig	Koerper
groß gewachsen	Koerper
lang	Koerper
hochgewachsen	Koerper
langgewachsen	Koerper
kurz	Koerper
kleingewachsen	Koerper
kurzgewachsen	Koerper
breithüftig	Koerper
breitschultrig	Koerper
breitkiefrig	Koerper
breitgesichtig	Koerper
schmalhüftig	Koerper
schmalbrüstig	Koerper
schmalschultrig	Koerper
schmallippig	Koerper
zierlich	Koerper
grazil	Koerper
gedrungen	Koerper
muskulös	Koerper
durchtrainiert	Koerper
sehnig	Koerper
drahtig	Koerper
einbeinig	Koerper
x-beinig	Koerper
o-beinig	Koerper
breitbeinig	Koerper
langbeinig	Koerper
kurzbeinig	Koerper
plattfüßig	Koerper
storchbeinig	Koerper
storchenbeinig	Koerper
dünnbeinig	Koerper
glubschäugig	Koerper
glasig	Koerper
wässrig	Koerper
modisch	Koerper
chic	Koerper
hohlwangig	Koerper
extravagant	Koerper
stylisch	Koerper
ausgefallen	Koerper
erlesen	Koerper
körperzustandsspezifisch	Koerper
fruchtbar	Koerper
fortpflanzungsfähig	Koerper
zeugungsfähig	Koerper
unfruchtbar	Koerper
zeugungsunfähig	Koerper
geschlechtsreif	Koerper
schwanger	Koerper
trächtig	Koerper
tragend	Koerper
menstruell	Koerper
prämenstruell	Koerper
potent	Koerper
impotent	Koerper
sexuell orientiert	Koerper
sexuell	Koerper
asexuell	Koerper
heterosexuell	Koerper
homosexuell	Koerper
schwul	Koerper
lesbisch	Koerper
bisexuell	Koerper
bi	Koerper
pervers	Koerper
fetischistisch	Koerper
nekrophil	Koerper
pädophil	Koerper
masochistisch	Koerper
devot	Koerper
sadistisch	Koerper
dominant	Koerper
körperteilspezifisch	Koerper
anal	Koerper
oral	Koerper
rektal	Koerper
dorsal	Koerper
spinal	Koerper
zerebral	Koerper
großwüchsig	Koerper
hell	Koerper
nicht behindert	Koerper
mengenspezifisch	Menge
zahlenspezifisch	Menge
zahlenmäßig	Menge
numerisch	Menge
nominal	Menge
nominell	Menge
ein	Menge
anderthalb	Menge
eineinhalb	Menge
zwei	Menge
zweieinhalb	Menge
drei	Menge
dreieinhalb	Menge
vier	Menge
viereinhalb	Menge
fünf	Menge
fünfeinhalb	Menge
sechs	Menge
sechseinhalb	Menge
sieben	Menge
siebeneinhalb	Menge
acht	Menge
achteinhalb	Menge
neun	Menge
neuneinhalb	Menge
zehn	Menge
zehneinhalb	Menge
elf	Menge
elfeinhalb	Menge
zwölf	Menge
zwölfeinhalb	Menge
dreizehn	Menge
dreizehneinhalb	Menge
vierzehn	Menge
vierzehneinhalb	Menge
fünfzehn	Menge
fünfzehneinhalb	Menge
sechzehn	Menge
sechzehneinhalb	Menge
siebzehn	Menge
siebzehneinhalb	Menge
achtzehn	Menge
achtzehneinhalb	Menge
neunzehn	Menge
neunzehneinhalb	Menge
zwanzig	Menge
einundzwanzig	Menge
zweiundzwanzig	Menge
dreiundzwanzig	Menge
vierundzwanzig	Menge
fünfundzwanzig	Menge
sechsundzwanzig	Menge
siebenundzwanzig	Menge
achtundzwanzig	Menge
neunundzwanzig	Menge
dreißig	Menge
vierzig	Menge
fünfzig	Menge
sechzig	Menge
siebzig	Menge
achtzig	Menge
neunzig	Menge
hundert	Menge
tausend	Menge
erste	Menge
allererst	Menge
vorletzt	Menge
letzt	Menge
zweite	Menge
dritte	Menge
vierte	Menge
fünfte	Menge
sechste	Menge
siebte	Menge
achte	Menge
neunte	Menge
zehnte	Menge
einköpfig	Menge
mehrköpfig	Menge
zweiköpfig	Menge
dreiköpfig	Menge
vierköpfig	Menge
fünfköpfig	Menge
sechsköpfig	Menge
siebenköpfig	Menge
achtköpfig	Menge
neunköpfig	Menge
zehnköpfig	Menge
-köpfig	Menge
zweiteilig	Menge
einbeinig	Menge
mehrbeinig	Menge
zweibeinig	Menge
dreibeinig	Menge
vierbeinig	Menge
fünfbeinig	Menge
einstellig	Menge
mehrstellig	Menge
zweistellig	Menge
dreistellig	Menge
vierstellig	Menge
fünfstellig	Menge
sechsstellig	Menge
einstufig	Menge
mehrstufig	Menge
zweistufig	Menge
dreistufig	Menge
vierstufig	Menge
einige	Menge
mehrere	Menge
geraum	Menge
alle	Menge
jeder	Menge
jeglicher	Menge
sämtlich	Menge
kein	Menge
keinerlei	Menge
viele	Menge
lauter	Menge
allerlei	Menge
quantitätsspezifisch	Menge
viel	Menge
zweitgrößte	Menge
mehrfach	Menge
vielfach	Menge
mannigfach	Menge
zweifach	Menge
doppelt	Menge
dreifach	Menge
vierfach	Menge
fünffach	Menge
sechsfach	Menge
siebenfach	Menge
achtfach	Menge
neunfach	Menge
zehnfach	Menge
hundertfach	Menge
tausendfach	Menge
reichlich	Menge
inflationär	Menge
zusätzlich	Menge
extra	Menge
gesondert	Menge
separat	Menge
getrennt	Menge
wenig	Menge
gering	Menge
minimal	Menge
mindest	Menge
wenigst	Menge
minder	Menge
maximal	Menge
mehrheitlich	Menge
hoch	Menge
groß	Menge
üppig	Menge
fürstlich	Menge
niedrig	Menge
erhöht	Menge
reich	Menge
reichhaltig	Menge
gehaltvoll	Menge
zahlreich	Menge
etlich	Menge
zig	Menge
zahllos	Menge
massenhaft	Menge
massig	Menge
voll	Menge
voll	Menge
gefüllt	Menge
prallvoll	Menge
randvoll	Menge
leer	Menge
geleert	Menge
entleert	Menge
leer stehend	Menge
genügend	Menge
genug	Menge
ausreichend	Menge
hinreichend	Menge
unzählig	Menge
ungezählt	Menge
immens	Menge
unermesslich	Menge
unerschöpflich	Menge
unausschöpflich	Menge
unschätzbar	Menge
überwiegend	Menge
vorwiegend	Menge
vornehmlich	Menge
weitestgehend	Menge
unzureichend	Menge
unzulänglich	Menge
ungenügend	Menge
arm	Menge
dürftig	Menge
kläglich	Menge
kärglich	Menge
ärmlich	Menge
blutarm	Menge
dünn	Menge
schütter	Menge
spärlich	Menge
licht	Menge
restlich	Menge
übrig	Menge
übrig geblieben	Menge
vorhanden	Menge
vorrätig	Menge
parat	Menge
griffbereit	Menge
erhältlich	Menge
verbraucht	Menge
aufgebraucht	Menge
kostenspezifisch	Menge
teuer	Menge
wertvoll	Menge
kostbar	Menge
kunstvoll	Menge
hochkarätig	Menge
hochwertig	Menge
armselig	Menge
erbärmlich	Menge
elend	Menge
notdürftig	Menge
jämmerlich	Menge
kümmerlich	Menge
schnöde	Menge
minderwertig	Menge
geringwertig	Menge
kostspielig	Menge
kostenintensiv	Menge
unerschwinglich	Menge
unbezahlbar	Menge
aufwändig	Menge
aufwendig	Menge
günstig	Menge
billig	Menge
spottbillig	Menge
feil	Menge
wohlfeil	Menge
erschwinglich	Menge
bezahlbar	Menge
finanzierbar	Menge
preiswert	Menge
kostengünstig	Menge
preisgünstig	Menge
geschenkt	Menge
kostenlos	Menge
bezahlt	Menge
vergütet	Menge
dotiert	Menge
unbezahlt	Menge
unvergütet	Menge
ehrenamtlich	Menge
ertragsspezifisch	Menge
einträglich	Menge
gewinnbringend	Menge
lukrativ	Menge
festverzinslich	Menge
festverzinst	Menge
effizient	Menge
ergiebig	Menge
ertragreich	Menge
ertragssicher	Menge
ertragsfähig	Menge
unergiebig	Menge
ertragsarm	Menge
verlustreich	Menge
verlustbringend	Menge
verblieben	Menge
drittgrößte	Menge
viertgrößte	Menge
fünftgrößte	Menge
sechstgrößte	Menge
flächengrößte	Menge
siebtgrößte	Menge
achtgrößte	Menge
zehntgrößte	Menge
neuntgrößte	Menge
nicht leer	Menge
klimatisch	natPhaenomen
landschaftsspezifisch	natPhaenomen
landschaftlich	natPhaenomen
gebirgig	natPhaenomen
bergig	natPhaenomen
bergisch	natPhaenomen
hügelig	natPhaenomen
mittelgebirgig	natPhaenomen
flach	natPhaenomen
eben	natPhaenomen
platt	natPhaenomen
fruchtbar	natPhaenomen
urbar	natPhaenomen
blühend	natPhaenomen
bewohnbar	natPhaenomen
unfruchtbar	natPhaenomen
öde	natPhaenomen
seenreich	natPhaenomen
karg	natPhaenomen
kahl	natPhaenomen
unbewohnbar	natPhaenomen
üppig	natPhaenomen
satt	natPhaenomen
trocken	natPhaenomen
trocken-kalt	natPhaenomen
feucht	natPhaenomen
nass	natPhaenomen
feuchtwarm	natPhaenomen
regnerisch	natPhaenomen
gewittrig	natPhaenomen
gewitterig	natPhaenomen
wechselhaft-regnerisch	natPhaenomen
schwül	natPhaenomen
schwülwarm	natPhaenomen
schwülheiß	natPhaenomen
drückend	natPhaenomen
lau	natPhaenomen
mild	natPhaenomen
lind	natPhaenomen
frisch	natPhaenomen
frostig	natPhaenomen
nasskalt	natPhaenomen
nasskühl	natPhaenomen
sonnig	natPhaenomen
strahlend	natPhaenomen
heiter	natPhaenomen
sommerlich-sonnig	natPhaenomen
bewölkt	natPhaenomen
wolkig	natPhaenomen
bedeckt	natPhaenomen
schattig	natPhaenomen
neblig	natPhaenomen
nebelverhangen	natPhaenomen
vernebelt	natPhaenomen
verhangen	natPhaenomen
trüb	natPhaenomen
diesig	natPhaenomen
dunstig	natPhaenomen
diesig-kalt	natPhaenomen
nebligtrüb	natPhaenomen
klar	natPhaenomen
wolkenlos	natPhaenomen
windig	natPhaenomen
stürmisch	natPhaenomen
böig	natPhaenomen
windstill	natPhaenomen
frühlingshaft	natPhaenomen
vorfrühlingshaft	natPhaenomen
sommerlich	natPhaenomen
hochsommerlich	natPhaenomen
spätsommerlich	natPhaenomen
winterlich	natPhaenomen
herbstlich	natPhaenomen
mediterran	natPhaenomen
kalifornisch	natPhaenomen
föhnig	natPhaenomen
tropisch	natPhaenomen
subtropisch	natPhaenomen
rau	natPhaenomen
unwirtlich	natPhaenomen
arktisch	natPhaenomen
orkanartig	natPhaenomen
steppenartig	natPhaenomen
ortsspezifisch	Ort
dimensionsspezifisch	Ort
lang	Ort
länglich	Ort
langgefasst	Ort
lang gefaßt	Ort
kilometerlang	Ort
meilenlang	Ort
weit	Ort
kilometerweit	Ort
meilenweit	Ort
endlos	Ort
unendlich	Ort
langstielig	Ort
kurz	Ort
knapp	Ort
kurzstielig	Ort
flach	Ort
niedrig	Ort
nieder	Ort
hoch	Ort
haushoch	Ort
zweigeschossig	Ort
dreigeschossig	Ort
steil	Ort
erhöht	Ort
flach	Ort
tief	Ort
abgrundtief	Ort
bodenlos	Ort
eng	Ort
weit	Ort
weitläufig	Ort
weiträumig	Ort
verbreitet	Ort
verzweigt	Ort
weltweit	Ort
europaweit	Ort
deutschlandweit	Ort
bundesweit	Ort
weltumfassend	Ort
weltumspannend	Ort
schmal	Ort
breit	Ort
einspurig	Ort
zweispurig	Ort
vierspurig	Ort
sechsspurig	Ort
achtspurig	Ort
umfassend	Ort
allumfassend	Ort
global	Ort
lokal	Ort
räumlich	Ort
flächig	Ort
großflächig	Ort
breitflächig	Ort
sperrig	Ort
klobig	Ort
klotzig	Ort
großräumig	Ort
geräumig	Ort
grenzüberschreitend	Ort
kleinräumig	Ort
richtungsspezifisch	Ort
nördlich	Ort
südlich	Ort
westlich	Ort
nordwestlich	Ort
südwestlich	Ort
östlich	Ort
nordöstlich	Ort
südöstlich	Ort
frontal	Ort
seitlich	Ort
kollateral	Ort
link	Ort
recht	Ort
parallel	Ort
lokalisationsspezifisch	Ort
frei	Ort
gefangen	Ort
unfrei	Ort
gefangengenommen	Ort
gefangengehalten	Ort
eingefangen	Ort
festgefangen	Ort
dingfest	Ort
gekidnapt	Ort
entführt	Ort
verhaftet	Ort
inhaftiert	Ort
festgenommen	Ort
arretiert	Ort
nah	Ort
nahe	Ort
knapp	Ort
haarscharf	Ort
ortsnah	Ort
nahegelegen	Ort
naheliegend	Ort
nebenstehend	Ort
umliegend	Ort
unweit	Ort
benachbart	Ort
angrenzend	Ort
naturnah	Ort
fern	Ort
entfernt	Ort
entfernt	Ort
abgelegen	Ort
einsam	Ort
jenseitig	Ort
diesseitig	Ort
überseeisch	Ort
vorder	Ort
hinter	Ort
ober	Ort
obig	Ort
oberst	Ort
unter	Ort
inner	Ort
innerlich	Ort
medial	Ort
mittig	Ort
äußerlich	Ort
intern	Ort
innerhalb	Ort
innerbetrieblich	Ort
inneruniversitär	Ort
innerparteilich	Ort
parteiintern	Ort
außerbetrieblich	Ort
überbetrieblich	Ort
betriebsübergreifend	Ort
außerparteilich	Ort
überparteilich	Ort
parteiübergreifend	Ort
äußer	Ort
zentral	Ort
dezentral	Ort
peripher	Ort
erreichbar	Ort
unterirdisch	Ort
überirdisch	Ort
oberirdisch	Ort
extraterrestrisch	Ort
außerirdisch	Ort
irdisch	Ort
terrestrisch	Ort
herkunftsspezifisch	Ort
einheimisch	Ort
indigen	Ort
heimisch	Ort
beheimatet	Ort
hiesig	Ort
außerhalb	Ort
extern	Ort
auswärtig	Ort
ansässig	Ort
gebürtig	Ort
ortsansässig	Ort
fremdstämmig	Ort
deutschstämmig	Ort
fremdartig	Ort
exotisch	Ort
unbekannt	Ort
fremd	Ort
unerforscht	Ort
unerkundet	Ort
dortig	Ort
anonym	Ort
ungenannt	Ort
bekannt	Ort
vertraut	Ort
geläufig	Ort
traut	Ort
gängig	Ort
familiär	Ort
erforscht	Ort
erkundet	Ort
berühmt	Ort
prominent	Ort
weltberühmt	Ort
namentlich	Ort
ausländisch	Ort
inländisch	Ort
alteingesessen	Ort
ursprünglich	Ort
archaisch	Ort
frühzeitlich	Ort
altertümlich	Ort
original	Ort
genuin	Ort
raumverteilungsspezifisch	Ort
voll	Ort
überfüllt	Ort
übervoll	Ort
leer	Ort
verstopft	Ort
schütter	Ort
spärlich	Ort
licht	Ort
dünn	Ort
unbesetzt	Ort
frei	Ort
unbelegt	Ort
verkehrsberuhigt	Ort
besetzt	Ort
belegt	Ort
vollbesetzt	Ort
überbelegt	Ort
ausgebucht	Ort
ausverkauft	Ort
formspezifisch	Ort
x-förmig	Ort
u-förmig	Ort
o-förmig	Ort
s-förmig	Ort
stromlinienförmig	Ort
schnittig	Ort
rund	Ort
kreisförmig	Ort
kreisrund	Ort
zirkular	Ort
zirkulär	Ort
oval	Ort
elliptisch	Ort
eirund	Ort
eiförmig	Ort
pyramidal	Ort
gerade	Ort
eben	Ort
grade	Ort
linear	Ort
nicht linear	Ort
kerzengerade	Ort
schnurgerade	Ort
krumm	Ort
diagonal	Ort
quer	Ort
senkrecht	Ort
vertikal	Ort
horizontal	Ort
waagerecht	Ort
gewellt	Ort
wellig	Ort
schief	Ort
schräg	Ort
abgeschrägt	Ort
windschief	Ort
geknickt	Ort
winkelig	Ort
winklig	Ort
rechtwinkelig	Ort
rechtwinklig	Ort
spitzwinkelig	Ort
spitzwinklig	Ort
stumpfwinkelig	Ort
stumpfwinklig	Ort
eckig	Ort
dreieckig	Ort
viereckig	Ort
achteckig	Ort
rechteckig	Ort
quadratisch	Ort
spitz	Ort
scharf	Ort
stumpf	Ort
abgestuft	Ort
stufenartig	Ort
stufig	Ort
stufenförmig	Ort
treppenartig	Ort
treppenförmig	Ort
terrassenartig	Ort
terrassenförmig	Ort
hochhackig	Ort
existenzspezifisch	Ort
vorhanden	Ort
existent	Ort
bestehend	Ort
vorliegend	Ort
anwesend	Ort
präsent	Ort
teilnehmend	Ort
partizipierend	Ort
allgegenwärtig	Ort
allzugegen	Ort
omnipräsent	Ort
abwesend	Ort
mangelnd	Ort
fehlend	Ort
befindlich	Ort
auffindbar	Ort
topografisch	Ort
gelöscht	Ort
erweitert	Ort
isoliert	Ort
nächstgelegen	Ort
netzartig	Ort
blattartig	Ort
parkartig	Ort
zeltartig	Ort
kleinflächig	Ort
wurmartig	Ort
sackartig	Ort
plateauartig	Ort
deutschblütig	Ort
gebäudeartig	Ort
existierend	Ort
turmartig	Ort
schlossartig	Ort
burgartig	Ort
palastartig	Ort
festungsartig	Ort
villenartig	Ort
nicht vorhanden	Ort
nicht existent	Ort
nicht existierend	Ort
nicht westlich	Ort
nicht westlich	Ort
nicht lokal	Ort
nicht zentral	Ort
höhlenartig	Ort
gitterartig	Ort
kuppelartig	Ort
schlauchartig	Ort
kammartig	Ort
tunnelartig	Ort
laubblattartig	Ort
flügelartig	Ort
röhrenartig	Ort
säulenartig	Ort
kelchartig	Ort
vorstehend	Ort
hervorstehend	Ort
untenstehend	Ort
obenstehend	Ort
überstehend	Ort
fortbestehend	Ort
umstehend	Ort
Pertonym Adjektiv	Pertonym
denom Kommunikation	Pertonym
denom Kognition	Pertonym
denom Koerper	Pertonym
denom Tier	Pertonym
denom Form	Pertonym
denom Geschehen	Pertonym
denom Besitz	Pertonym
denom Gruppe	Pertonym
denom Relation	Pertonym
denom Artefakt	Pertonym
denom Motiv	Pertonym
denom Ort	Pertonym
denom Mensch	Pertonym
denom Substanz	Pertonym
denom Pflanze	Pertonym
denom Menge	Pertonym
denom Attribut	Pertonym
denom Zeit	Pertonym
denom Tops	Pertonym
denom natGegenstand	Pertonym
denom Gefuehl	Pertonym
denom natPhaenomen	Pertonym
adverbial	Pertonym
adverbiell	Pertonym
appositionell	Pertonym
arteriell	Pertonym
bakteriell	Pertonym
bronchial	Pertonym
dimensional	Pertonym
eindimensional	Pertonym
zweidimensional	Pertonym
dreidimensional	Pertonym
plastisch	Pertonym
experimental	Pertonym
experimentell	Pertonym
fiktional	Pertonym
selektiv	Pertonym
auswählend	Pertonym
figural	Pertonym
finanziell	Pertonym
preislich	Pertonym
tariflich	Pertonym
wertmäßig	Pertonym
formal	Pertonym
fraktionell	Pertonym
funktional	Pertonym
funktionell	Pertonym
herrschaftlich	Pertonym
vegetativ	Pertonym
hegemonial	Pertonym
hegemonisch	Pertonym
aerodynamisch	Pertonym
morphologisch	Pertonym
semantisch	Pertonym
völkisch	Pertonym
fremdsprachig	Pertonym
apostolisch	Pertonym
herzoglich	Pertonym
kurfürstlich	Pertonym
sandig	Pertonym
hellenistisch	Pertonym
evolutionär	Pertonym
neurologisch	Pertonym
zivilisatorisch	Pertonym
zylindrisch	Pertonym
lexikalisch	Pertonym
grammatisch	Pertonym
börslich	Pertonym
nachbörslich	Pertonym
nachrichtendienstlich	Pertonym
horizontal	Pertonym
hormonal	Pertonym
hormonell	Pertonym
industriell	Pertonym
informationell	Pertonym
informativ	Pertonym
verfassungsmäßig	Pertonym
felsig	Pertonym
versicherungstechnisch	Pertonym
versicherungsmäßig	Pertonym
medial	Pertonym
infrastrukturell	Pertonym
institutionell	Pertonym
instrumental	Pertonym
instrumentell	Pertonym
intentional	Pertonym
kantonal	Pertonym
katastrophal	Pertonym
pornografisch	Pertonym
kolonial	Pertonym
kolossal	Pertonym
kommerziell	Pertonym
kommunal	Pertonym
konditional	Pertonym
konditionell	Pertonym
konfessionell	Pertonym
föderal	Pertonym
föderalistisch	Pertonym
zentralistisch	Pertonym
konjektural	Pertonym
konstitutionell	Pertonym
konstitutionell	Pertonym
kontextuell	Pertonym
konventionell	Pertonym
konventional	Pertonym
konzeptionell	Pertonym
analytisch	Pertonym
architektonisch	Pertonym
fiktiv	Pertonym
kulturell	Pertonym
rassisch	Pertonym
publizistisch	Pertonym
maschinell	Pertonym
materiell	Pertonym
ministerial	Pertonym
ministeriell	Pertonym
bischöflich	Pertonym
erzbischöflich	Pertonym
päpstlich	Pertonym
gerichtlich	Pertonym
außergerichtlich	Pertonym
staatsanwaltschaftlich	Pertonym
richterlich	Pertonym
höchstrichterlich	Pertonym
monumental	Pertonym
nasal	Pertonym
nasal	Pertonym
national	Pertonym
bundesrepublikanisch	Pertonym
bundesrepublikanisch	Pertonym
notariell	Pertonym
notarisch	Pertonym
diakonisch	Pertonym
oppositionell	Pertonym
oppositionell	Pertonym
dialektisch	Pertonym
dialektisch	Pertonym
pflanzlich	Pertonym
orbital	Pertonym
orchestral	Pertonym
philharmonisch	Pertonym
sinfonisch	Pertonym
ornamental	Pertonym
partizipial	Pertonym
pastoral	Pertonym
personell	Pertonym
personal	Pertonym
personenbezogen	Pertonym
persönlich	Pertonym
elterlich	Pertonym
phänomenal	Pertonym
positionell	Pertonym
präpositional	Pertonym
prinzipiell	Pertonym
professionell	Pertonym
treuhändisch	Pertonym
treuhänderisch	Pertonym
professoral	Pertonym
pronominal	Pertonym
proportional	Pertonym
prozentual	Pertonym
prozentuell	Pertonym
quantitativ	Pertonym
rational	Pertonym
redaktionell	Pertonym
sakramental	Pertonym
seriell	Pertonym
sexuell	Pertonym
sexual	Pertonym
strukturell	Pertonym
struktural	Pertonym
substanziell	Pertonym
synagogal	Pertonym
synodal	Pertonym
synodisch	Pertonym
tangential	Pertonym
tendenziell	Pertonym
thermal	Pertonym
thermisch	Pertonym
museal	Pertonym
tonal	Pertonym
traditionell	Pertonym
triumphal	Pertonym
vaginal	Pertonym
vektoriell	Pertonym
verbal	Pertonym
zentrifugal	Pertonym
zeremoniell	Pertonym
funky	Pertonym
adjektivisch	Pertonym
ägyptologisch	Pertonym
archäologisch	Pertonym
didaktisch	Pertonym
diagnostisch	Pertonym
akademisch	Pertonym
universitär	Pertonym
akrobatisch	Pertonym
algebraisch	Pertonym
geometrisch	Pertonym
alkalisch	Pertonym
alkoholisch	Pertonym
steinig	Pertonym
alkoholfrei	Pertonym
folkloristisch	Pertonym
szenisch	Pertonym
allegorisch	Pertonym
allergisch	Pertonym
alphabetisch	Pertonym
amphibisch	Pertonym
anglistisch	Pertonym
automatisch	Pertonym
vollautomatisch	Pertonym
halbautomatisch	Pertonym
semiautomatisch	Pertonym
beruflich	Pertonym
gewerblich	Pertonym
steuerlich	Pertonym
fiskalisch	Pertonym
gastronomisch	Pertonym
biologisch	Pertonym
zoologisch	Pertonym
botanisch	Pertonym
therapeutisch	Pertonym
psychotherapeutisch	Pertonym
psychoanalytisch	Pertonym
volkskundlich	Pertonym
ethnologisch	Pertonym
genetisch	Pertonym
geografisch	Pertonym
geologisch	Pertonym
chemisch	Pertonym
biochemisch	Pertonym
dramaturgisch	Pertonym
studentisch	Pertonym
dominikanisch	Pertonym
franziskanisch	Pertonym
benediktinisch	Pertonym
johannitisch	Pertonym
zisterziensisch	Pertonym
unternehmerisch	Pertonym
vatikanisch	Pertonym
elektrisch	Pertonym
schattig	Pertonym
elektronisch	Pertonym
germanistisch	Pertonym
geschichtlich	Pertonym
historisch	Pertonym
zeitgeschichtlich	Pertonym
geistesgeschichtlich	Pertonym
humanistisch	Pertonym
wilhelminisch	Pertonym
viktorianisch	Pertonym
aufklärerisch	Pertonym
rationalistisch	Pertonym
behaviouristisch	Pertonym
strukturalistisch	Pertonym
romantizistisch	Pertonym
kirchengeschichtlich	Pertonym
calvinistisch	Pertonym
methodistisch	Pertonym
kulturgeschichtlich	Pertonym
kulturhistorisch	Pertonym
kunstgeschichtlich	Pertonym
kunsthistorisch	Pertonym
mittelalterlich	Pertonym
spätmittelalterlich	Pertonym
frühmittelalterlich	Pertonym
postmodern	Pertonym
frühgeschichtlich	Pertonym
vorgeschichtlich	Pertonym
prähistorisch	Pertonym
ideologisch	Pertonym
weltanschaulich	Pertonym
inhaltlich	Pertonym
thematisch	Pertonym
journalistisch	Pertonym
juristisch	Pertonym
kolonialistisch	Pertonym
gewerkschaftlich	Pertonym
geheimdienstlich	Pertonym
genossenschaftlich	Pertonym
künstlerisch	Pertonym
stimmlich	Pertonym
kompositorisch	Pertonym
islamistisch	Pertonym
dadaistisch	Pertonym
genealogisch	Pertonym
phonetisch	Pertonym
geodätisch	Pertonym
gotisch	Pertonym
neugotisch	Pertonym
frühgotisch	Pertonym
spätgotisch	Pertonym
klassizistisch	Pertonym
surrealistisch	Pertonym
impressionistisch	Pertonym
expressionistisch	Pertonym
barock	Pertonym
landwirtschaftlich	Pertonym
betriebswirtschaftlich	Pertonym
volkswirtschaftlich	Pertonym
kaufmännisch	Pertonym
bäuerlich	Pertonym
gesanglich	Pertonym
polizeilich	Pertonym
kriminalistisch	Pertonym
urkundlich	Pertonym
literarisch	Pertonym
lyrisch	Pertonym
episch	Pertonym
liturgisch	Pertonym
mathematisch	Pertonym
arithmetisch	Pertonym
rechnerisch	Pertonym
statistisch	Pertonym
stochastisch	Pertonym
medizinal	Pertonym
gesundheitlich	Pertonym
nervlich	Pertonym
hygienisch	Pertonym
sanitär	Pertonym
ganzheitlich	Pertonym
militärisch	Pertonym
handwerklich	Pertonym
militaristisch	Pertonym
musikalisch	Pertonym
naturwissenschaftlich	Pertonym
poulärwissenschaftlich	Pertonym
geisteswissenschaftlich	Pertonym
gesellschaftswissenschaftlich	Pertonym
geheimwissenschaftlich	Pertonym
esoterisch	Pertonym
okkultistisch	Pertonym
soziologisch	Pertonym
sozialwissenschaftlich	Pertonym
demografisch	Pertonym
bevölkerungswissenschaftlich	Pertonym
theologisch	Pertonym
olympisch	Pertonym
weihnachtlich	Pertonym
organisatorisch	Pertonym
pädagogisch	Pertonym
erzieherisch	Pertonym
parlamentarisch	Pertonym
gesetzgeberisch	Pertonym
praktisch	Pertonym
praxisbezogen	Pertonym
angewandt	Pertonym
anwendungsbezogen	Pertonym
anwenderfreundlich	Pertonym
benutzerfreundlich	Pertonym
theoretisch	Pertonym
philosophisch	Pertonym
physikalisch	Pertonym
ballistisch	Pertonym
ionisch	Pertonym
logistisch	Pertonym
poetisch	Pertonym
psychologisch	Pertonym
rechtlich	Pertonym
kartellrechtlich	Pertonym
logistisch	Pertonym
poetisch	Pertonym
psychologisch	Pertonym
physiologisch	Pertonym
disziplinarisch	Pertonym
strafrechtlich	Pertonym
zivilrechtlich	Pertonym
steuerrechtlich	Pertonym
atomrechtlich	Pertonym
baurechtlich	Pertonym
völkerrechtlich	Pertonym
qualitativ	Pertonym
verfassungsrechtlich	Pertonym
arbeitsrechtlich	Pertonym
sprachwissenschaftlich	Pertonym
linguistisch	Pertonym
technisch	Pertonym
technologisch	Pertonym
gentechnisch	Pertonym
sicherheitstechnisch	Pertonym
kerntechnisch	Pertonym
atomtechnisch	Pertonym
tontechnisch	Pertonym
biotechnisch	Pertonym
pyrotechnisch	Pertonym
vulkanisch	Pertonym
hannoversch	Pertonym
hydraulisch	Pertonym
elektrotechnisch	Pertonym
flugtechnisch	Pertonym
produktionstechnisch	Pertonym
telefonisch	Pertonym
telephonisch	Pertonym
biblisch	Pertonym
wirtschaftlich	Pertonym
gesamtwirtschaftlich	Pertonym
privatwirtschaftlich	Pertonym
weltwirtschaftlich	Pertonym
konjunkturell	Pertonym
marktwirtschaftlich	Pertonym
psychiatrisch	Pertonym
wissenschaftlich	Pertonym
methodisch	Pertonym
wissenschaftsmethodisch	Pertonym
hermeneutisch	Pertonym
empirisch	Pertonym
induktiv	Pertonym
deduktiv	Pertonym
klinisch	Pertonym
ärztlich	Pertonym
fachärztlich	Pertonym
klinisch	Pertonym
zahnärztlich	Pertonym
chirurgisch	Pertonym
gynäkologisch	Pertonym
urologisch	Pertonym
radiologisch	Pertonym
orthopädisch	Pertonym
internistisch	Pertonym
psychiatrisch	Pertonym
augenärztlich	Pertonym
gerichtsärztlich	Pertonym
gerichtsmedizinisch	Pertonym
amtsärztlich	Pertonym
tierärztlich	Pertonym
veterinärmedizinisch	Pertonym
pathologisch	Pertonym
humanmedizinisch	Pertonym
kassenärztlich	Pertonym
kassenzahnärztlich	Pertonym
betriebsärztlich	Pertonym
assistenzärztlich	Pertonym
krankenhausärztlich	Pertonym
klinikärztlich	Pertonym
kurärztlich	Pertonym
badeärztlich	Pertonym
schulärztlich	Pertonym
vereinsärztlich	Pertonym
stationsärztlich	Pertonym
oberärztlich	Pertonym
chefärztlich	Pertonym
praktikumsärztlich	Pertonym
militärärztlich	Pertonym
betrieblich	Pertonym
touristisch	Pertonym
massentouristisch	Pertonym
ökologisch	Pertonym
baulich	Pertonym
städtebaulich	Pertonym
bebildert	Pertonym
illustriert	Pertonym
kosmetisch	Pertonym
hierarchisch	Pertonym
hoheitlich	Pertonym
mechanisch	Pertonym
fußballerisch	Pertonym
handballerisch	Pertonym
ursächlich	Pertonym
bildlich	Pertonym
bildhaft	Pertonym
figurativ	Pertonym
filmisch	Pertonym
fotografisch	Pertonym
menschlich	Pertonym
tierisch	Pertonym
geistig	Pertonym
mental	Pertonym
psychisch	Pertonym
spirituell	Pertonym
überschüssig	Pertonym
seelisch	Pertonym
körperlich	Pertonym
physisch	Pertonym
organisch	Pertonym
mündlich	Pertonym
schriftlich	Pertonym
brieflich	Pertonym
handgeschrieben	Pertonym
handschriftlich	Pertonym
äffisch	Pertonym
liedhaft	Pertonym
formelhaft	Pertonym
sinnbildlich	Pertonym
sinnbildhaft	Pertonym
metaphorisch	Pertonym
mythisch	Pertonym
mythologisch	Pertonym
anekdotenhaft	Pertonym
bienenhaft	Pertonym
dämonenhaft	Pertonym
elfenhaft	Pertonym
engelhaft	Pertonym
episodenhaft	Pertonym
episodisch	Pertonym
feenhaft	Pertonym
floskelhaft	Pertonym
madonnenhaft	Pertonym
maskenhaft	Pertonym
modellhaft	Pertonym
mythenhaft	Pertonym
nixenhaft	Pertonym
nomadenhaft	Pertonym
nymphenhaft	Pertonym
angelsächsisch	Pertonym
bretonisch	Pertonym
athenisch	Pertonym
anglikanisch	Pertonym
atmosphärisch	Pertonym
atmosphärisch	Pertonym
solar	Pertonym
lunar	Pertonym
marin	Pertonym
nautisch	Pertonym
maritim	Pertonym
maritim	Pertonym
kosmisch	Pertonym
universal	Pertonym
charakterlich	Pertonym
apokalyptisch	Pertonym
astronomisch	Pertonym
ehelich	Pertonym
brüderlich	Pertonym
geschwisterlich	Pertonym
väterlich	Pertonym
mütterlich	Pertonym
klösterlich	Pertonym
priesterhaft	Pertonym
puppenhaft	Pertonym
puppig	Pertonym
skizzenhaft	Pertonym
schematisch	Pertonym
argumentativ	Pertonym
statuenhaft	Pertonym
tantenhaft	Pertonym
zigeunerhaft	Pertonym
zigeunerisch	Pertonym
tarifvertraglich	Pertonym
zwitterhaft	Pertonym
zwittrig	Pertonym
göttergleich	Pertonym
atomar	Pertonym
nuklear	Pertonym
modular	Pertonym
molekular	Pertonym
stofflich	Pertonym
partikular	Pertonym
partikulär	Pertonym
planetar	Pertonym
planetarisch	Pertonym
territorial	Pertonym
skalar	Pertonym
gräflich	Pertonym
luxuriös	Pertonym
glamourös	Pertonym
mafiös	Pertonym
mafios	Pertonym
steuerpflichtig	Pertonym
schulpflichtig	Pertonym
meldepflichtig	Pertonym
haftpflichtig	Pertonym
anzeigepflichtig	Pertonym
mitteilungspflichtig	Pertonym
zustimmungspflichtig	Pertonym
sozialversicherungspflichtig	Pertonym
gebührenpflichtig	Pertonym
kostenpflichtig	Pertonym
pflichtgemäß	Pertonym
sinngemäß	Pertonym
turnusgemäß	Pertonym
wahrheitsgemäß	Pertonym
massenweise	Pertonym
probeweise	Pertonym
streckenweise	Pertonym
versuchsweise	Pertonym
wechselweise	Pertonym
zwangsweise	Pertonym
auszugweise	Pertonym
kognitiv	Pertonym
formaljuristisch	Pertonym
semi-professionell	Pertonym
kleinbäuerlich	Pertonym
kleingeschrieben	Pertonym
großherzoglich	Pertonym
großtechnisch	Pertonym
großgeschrieben	Pertonym
großindustriell	Pertonym
großväterlich	Pertonym
großbäuerlich	Pertonym
kleingeistig	Pertonym
nicht kommerziell	Pertonym
nicht landwirtschaftlich	Pertonym
nicht technisch	Pertonym
nicht wissenschaftlich	Pertonym
nicht olympisch	Pertonym
nicht ärztlich	Pertonym
nicht akademisch	Pertonym
nicht gewerblich	Pertonym
nicht proportional	Pertonym
nicht fiktional	Pertonym
nicht ionisch	Pertonym
nicht professionell	Pertonym
nicht selektiv	Pertonym
nicht hierarchisch	Pertonym
nicht universitär	Pertonym
nicht empirisch	Pertonym
nicht konfessionell	Pertonym
nicht bäuerlich	Pertonym
tributpflichtig	Pertonym
zehntpflichtig	Pertonym
versicherungspflichtig	Pertonym
zulassungspflichtig	Pertonym
genehmigungspflichtig	Pertonym
verschreibungspflichtig	Pertonym
rezeptpflichtig	Pertonym
wehrpflichtig	Pertonym
beitragspflichtig	Pertonym
abgabepflichtig	Pertonym
abgabenpflichtig	Pertonym
apothekenpflichtig	Pertonym
zinspflichtig	Pertonym
lizenzpflichtig	Pertonym
dienstpflichtig	Pertonym
unterhaltspflichtig	Pertonym
zollpflichtig	Pertonym
einkommenssteuerpflichtig	Pertonym
zuschlagpflichtig	Pertonym
intensivpflichtig	Pertonym
anmeldepflichtig	Pertonym
lohnsteuerpflichtig	Pertonym
rentenversicherungspflichtig	Pertonym
nicht menschlich	Pertonym
enzyklopädisch	Pertonym
nicht enzyklopädisch	Pertonym
nicht materiell	Pertonym
nicht physisch	Pertonym
magisch	Pertonym
mystisch	Pertonym
aufbewahrungspflichtig	Pertonym
bewilligungspflichtig	Pertonym
informationspflichtig	Pertonym
beweispflichtig	Pertonym
nichtzulassungspflichtig	Pertonym
ablieferungspflichtig	Pertonym
nichtverschreibungspflichtig	Pertonym
kennzeichnungspflichtig	Pertonym
vorschulpflichtig	Pertonym
weinabgabepflichtig	Pertonym
lehnspflichtig	Pertonym
aufsichtspflichtig	Pertonym
patentpflichtig	Pertonym
militärpflichtig	Pertonym
waffenbesitzkartenpflichtig	Pertonym
kühlpflichtig	Pertonym
grundsteuerpflichtig	Pertonym
erbschaftssteuerpflichtig	Pertonym
körperschaftssteuerpflichtig	Pertonym
umsatzsteuerpflichtig	Pertonym
barunterhaltspflichtig	Pertonym
nicht elektrisch	Pertonym
stufenweise	Pertonym
näherungsweise	Pertonym
punktweise	Pertonym
ansatzweise	Pertonym
fallweise	Pertonym
schichtweise	Pertonym
abschnittsweise	Pertonym
wahlweise	Pertonym
wahrnehmungsspezifisch	Perzeption
multimedial	Perzeption
audiovisuell	Perzeption
wahrnehmbar	Perzeption
sichtspezifisch	Perzeption
optisch	Perzeption
visuell	Perzeption
sichtbar	Perzeption
unsichtbar	Perzeption
unerkennbar	Perzeption
unkenntlich	Perzeption
erkennbar	Perzeption
ersichtlich	Perzeption
kenntlich	Perzeption
erfahrbar	Perzeption
recherchierbar	Perzeption
exponiert	Perzeption
deutlich	Perzeption
überdeutlich	Perzeption
lesbar	Perzeption
ablesbar	Perzeption
auslesbar	Perzeption
unleserlich	Perzeption
scharf	Perzeption
undeutlich	Perzeption
diffus	Perzeption
durchsichtig	Perzeption
transparent	Perzeption
opak	Perzeption
undurchsichtig	Perzeption
blickdicht	Perzeption
milchig	Perzeption
verschwommen	Perzeption
schemenhaft	Perzeption
belebt	Perzeption
unbelebt	Perzeption
besiedelt	Perzeption
bewohnt	Perzeption
unbesiedelt	Perzeption
unbewohnt	Perzeption
spürbar	Perzeption
fühlbar	Perzeption
unhörbar	Perzeption
hörbar	Perzeption
unüberhörbar	Perzeption
unübersehbar	Perzeption
unignorierbar	Perzeption
bemerkbar	Perzeption
merklich	Perzeption
unmerklich	Perzeption
feststellbar	Perzeption
wahrgenommen	Perzeption
beobachtet	Perzeption
bemerkt	Perzeption
helligkeitsspezifisch	Perzeption
hell	Perzeption
grell	Perzeption
lichterloh	Perzeption
dunkel	Perzeption
düster	Perzeption
duster	Perzeption
finster	Perzeption
zappenduster	Perzeption
stockdunkel	Perzeption
stockfinster	Perzeption
dämmerig	Perzeption
dämmrig	Perzeption
halbdunkel	Perzeption
schummerig	Perzeption
schummrig	Perzeption
beleuchtet	Perzeption
erleuchtet	Perzeption
unbeleuchtet	Perzeption
farbspezifisch	Perzeption
farblich	Perzeption
farbig	Perzeption
bunt	Perzeption
mehrfarbig	Perzeption
vielfarbig	Perzeption
farbenprächtig	Perzeption
farbenfroh	Perzeption
kunterbunt	Perzeption
knallig	Perzeption
knallbunt	Perzeption
poppig	Perzeption
regenbogenfarben	Perzeption
gemustert	Perzeption
gestreift	Perzeption
quer gestreift	Perzeption
längs gestreift	Perzeption
kariert	Perzeption
gepunktet	Perzeption
gefleckt	Perzeption
fleckig	Perzeption
gesprenkelt	Perzeption
geblümt	Perzeption
texturiert	Perzeption
gemasert	Perzeption
marmoriert	Perzeption
uni	Perzeption
einfarbig	Perzeption
gedämpft	Perzeption
pastellfarben	Perzeption
pastellig	Perzeption
pastell	Perzeption
aquarellfarben	Perzeption
weiß	Perzeption
weißlich	Perzeption
schneeweiß	Perzeption
schwarz	Perzeption
rabenschwarz	Perzeption
pechschwarz	Perzeption
kohlrabenschwarz	Perzeption
rot	Perzeption
blutrot	Perzeption
rubinrot	Perzeption
knallrot	Perzeption
rötlich	Perzeption
kastanienrot	Perzeption
rostrot	Perzeption
bräunlichrot	Perzeption
braun	Perzeption
rostbraun	Perzeption
rötlichbraun	Perzeption
rostfarben	Perzeption
kaffeebraun	Perzeption
hellrot	Perzeption
magmarot	Perzeption
glühendrot	Perzeption
orange	Perzeption
orangefarben	Perzeption
dunkelrot	Perzeption
tiefrot	Perzeption
rosa	Perzeption
rosafarben	Perzeption
rosig	Perzeption
altrosa	Perzeption
altrosafarben	Perzeption
pink	Perzeption
pinkfarben	Perzeption
purpurrot	Perzeption
purpurfarben	Perzeption
purpurfarbig	Perzeption
sattrot	Perzeption
blau	Perzeption
dunkelblau	Perzeption
tiefblau	Perzeption
marine	Perzeption
marineblau	Perzeption
hellblau	Perzeption
himmelblau	Perzeption
azurblau	Perzeption
pastellblau	Perzeption
violett	Perzeption
veilchenfarben	Perzeption
gelb	Perzeption
gelblich	Perzeption
zitronengelb	Perzeption
falb	Perzeption
grün	Perzeption
hellgrün	Perzeption
giftgrün	Perzeption
grasgrün	Perzeption
dunkelgrün	Perzeption
tannengrün	Perzeption
flaschengrün	Perzeption
kakifarben	Perzeption
kaki	Perzeption
oliv	Perzeption
olivgrün	Perzeption
blaßrosa	Perzeption
blassrosa	Perzeption
metallfarben	Perzeption
silberfarben	Perzeption
goldfarben	Perzeption
bronzefarben	Perzeption
kupferfarben	Perzeption
hautfarben	Perzeption
fleischfarben	Perzeption
türkis	Perzeption
türkisfarben	Perzeption
blaugrün	Perzeption
lila	Perzeption
lilafarben	Perzeption
fliederfarben	Perzeption
grau	Perzeption
anthrazit	Perzeption
anthrazitfarben	Perzeption
aschgrau	Perzeption
silbergrau	Perzeption
metallicgrau	Perzeption
sandfarben	Perzeption
erdfarben	Perzeption
ockerfarben	Perzeption
ockergelb	Perzeption
cremefarben	Perzeption
beige	Perzeption
beigefarben	Perzeption
lachsfarben	Perzeption
pfirsichfarben	Perzeption
apricot	Perzeption
neonfarben	Perzeption
auberginefarben	Perzeption
safranfarben	Perzeption
magentafarben	Perzeption
bernsteinfarben	Perzeption
neongrün	Perzeption
leuchtendrot	Perzeption
farblos	Perzeption
achromatisch	Perzeption
fahl	Perzeption
aschfahl	Perzeption
schwarzweiß	Perzeption
bleich	Perzeption
blass	Perzeption
dezent	Perzeption
zurückhaltend	Perzeption
unauffällig	Perzeption
verschossen	Perzeption
verblasst	Perzeption
ausgebleicht	Perzeption
gebleicht	Perzeption
verblichen	Perzeption
auffällig	Perzeption
kräftig	Perzeption
lebhaft	Perzeption
lebendig	Perzeption
leuchtend	Perzeption
grell	Perzeption
schreiend	Perzeption
akustisch	Perzeption
klanglich	Perzeption
auditorisch	Perzeption
auditiv	Perzeption
geräuschspezifisch	Perzeption
laut	Perzeption
geräuschvoll	Perzeption
dröhnend	Perzeption
vernehmlich	Perzeption
ohrenbetäubend	Perzeption
schrill	Perzeption
durchdringend	Perzeption
leise	Perzeption
ruhig	Perzeption
still	Perzeption
geräuschlos	Perzeption
sacht	Perzeption
sachte	Perzeption
dunkel	Perzeption
metallisch	Perzeption
dumpf	Perzeption
gedämpft	Perzeption
harmonisch	Perzeption
wohlklingend	Perzeption
melodisch	Perzeption
unharmonisch	Perzeption
dissonant	Perzeption
einstimmig	Perzeption
unisono	Perzeption
gregorianisch	Perzeption
mehrstimmig	Perzeption
geschmacksspezifisch	Perzeption
süß	Perzeption
süßlich	Perzeption
zuckersüß	Perzeption
sauer	Perzeption
säuerlich	Perzeption
salzig	Perzeption
versalzen	Perzeption
übersalzen	Perzeption
bitter	Perzeption
zartbitter	Perzeption
herb	Perzeption
scharf	Perzeption
geschmackvoll	Perzeption
würzig	Perzeption
pikant	Perzeption
megascharf	Perzeption
deftig	Perzeption
herzhaft	Perzeption
geschmacklos	Perzeption
fade	Perzeption
wässerig	Perzeption
wässrig	Perzeption
mild	Perzeption
wohlschmeckend	Perzeption
köstlich	Perzeption
lecker	Perzeption
schmackhaft	Perzeption
kulinarisch	Perzeption
feinschmeckerisch	Perzeption
süffig	Perzeption
trocken	Perzeption
fruchtig	Perzeption
spritzig	Perzeption
erfrischend	Perzeption
geruchsspezifisch	Perzeption
brenzelig	Perzeption
brenzlig	Perzeption
verbrannt	Perzeption
aromatisch	Perzeption
streng	Perzeption
stechend	Perzeption
beißend	Perzeption
scharf	Perzeption
ätzend	Perzeption
muffig	Perzeption
miefig	Perzeption
moschusartig	Perzeption
erdig	Perzeption
oberflächenspezifisch	Perzeption
rau	Perzeption
weich	Perzeption
rutschig	Perzeption
glatt	Perzeption
glitschig	Perzeption
glibberig	Perzeption
rutschfest	Perzeption
flauschig	Perzeption
eben	Perzeption
glatt	Perzeption
plan	Perzeption
seidig	Perzeption
uneben	Perzeption
runzelig	Perzeption
runzlig	Perzeption
schrumpelig	Perzeption
schrumplig	Perzeption
verschrumpelt	Perzeption
straff	Perzeption
glänzend	Perzeption
schillernd	Perzeption
changierend	Perzeption
schimmernd	Perzeption
matt	Perzeption
stumpf	Perzeption
blank	Perzeption
blankgeputzt	Perzeption
gewienert	Perzeption
blitzblank	Perzeption
faltig	Perzeption
hell	Perzeption
erscheinend	Perzeption
schachbrettartig	Perzeption
kleinkariert	Perzeption
zartgelb	Perzeption
mosaikartig	Perzeption
salzartig	Perzeption
privativspezifisch	privativ
fassungslos	privativ
entsetzt	privativ
entgeistert	privativ
zinslos	privativ
zinsfrei	privativ
makellos	privativ
ebenmäßig	privativ
maßlos	privativ
unmäßig	privativ
übermäßig	privativ
übertrieben	privativ
überzogen	privativ
überhöht	privativ
bedingungslos	privativ
klanglos	privativ
ersatzlos	privativ
wahllos	privativ
wirkungslos	privativ
lückenlos	privativ
verantwortungslos	privativ
rücksichtslos	privativ
schamlos	privativ
ruchlos	privativ
pausenlos	privativ
bedeutungslos	privativ
sprachlos	privativ
stumm	privativ
gewaltlos	privativ
geschmacklos	privativ
stillos	privativ
kitschig	privativ
billig	privativ
vorbehaltlos	privativ
grundlos	privativ
trostlos	privativ
trist	privativ
belanglos	privativ
kompromisslos	privativ
gegenstandslos	privativ
schnurlos	privativ
schadlos	privativ
namenlos	privativ
folgenlos	privativ
ahnungslos	privativ
fraktionslos	privativ
kommentarlos	privativ
lautlos	privativ
bedenkenlos	privativ
schonungslos	privativ
schlaflos	privativ
lustlos	privativ
freudlos	privativ
zwanglos	privativ
achtlos	privativ
schutzlos	privativ
wehrlos	privativ
wertlos	privativ
konkurrenzlos	privativ
zeitlos	privativ
kinderlos	privativ
wortlos	privativ
drahtlos	privativ
kritiklos	privativ
haltlos	privativ
ausweglos	privativ
leblos	privativ
hirnlos	privativ
schuldlos	privativ
klaglos	privativ
farblos	privativ
gedankenlos	privativ
unbedacht	privativ
fruchtlos	privativ
glanzlos	privativ
formlos	privativ
erwerbslos	privativ
arbeitslos	privativ
ziellos	privativ
atemlos	privativ
außer Atem	privativ
schmerzlos	privativ
neidlos	privativ
gratis	privativ
kostenlos	privativ
kostenfrei	privativ
umsonst	privativ
unentgeltlich	privativ
lieblos	privativ
fensterlos	privativ
einfallslos	privativ
ideenlos	privativ
kraftlos	privativ
respektlos	privativ
heimatlos	privativ
vaterlandslos	privativ
gewissenlos	privativ
skrupellos	privativ
niveaulos	privativ
geistlos	privativ
klassenlos	privativ
gesichtslos	privativ
zahnlos	privativ
verständnislos	privativ
orientierungslos	privativ
gehörlos	privativ
teilnahmslos	privativ
witzlos	privativ
schmucklos	privativ
risikolos	privativ
gefahrlos	privativ
inhaltslos	privativ
inhaltsleer	privativ
spurlos	privativ
sinnlos	privativ
konzeptionslos	privativ
planlos	privativ
konfus	privativ
fehlerlos	privativ
fehlerfrei	privativ
ärmellos	privativ
unterschiedslos	privativ
parteilos	privativ
parteifrei	privativ
anspruchslos	privativ
zügellos	privativ
hemmungslos	privativ
taktlos	privativ
humorlos	privativ
wunschlos	privativ
willenlos	privativ
rückhaltlos	privativ
geschichtslos	privativ
übergangslos	privativ
stufenlos	privativ
schwerelos	privativ
arglos	privativ
zusammenhanglos	privativ
staatenlos	privativ
rechtlos	privativ
phantasielos	privativ
geräuschlos	privativ
uferlos	privativ
bodenlos	privativ
heillos	privativ
kopflos	privativ
mutlos	privativ
bruchlos	privativ
beschäftigungslos	privativ
unbeschäftigt	privativ
schnörkellos	privativ
mühelos	privativ
anstrengungslos	privativ
bewegungslos	privativ
waffenlos	privativ
unbewaffnet	privativ
bewaffnet	privativ
ruhelos	privativ
rastlos	privativ
beziehungslos	privativ
wolkenlos	privativ
wolkenfrei	privativ
gefühllos	privativ
emotionslos	privativ
baumlos	privativ
richtungslos	privativ
rettungslos	privativ
profillos	privativ
perspektivlos	privativ
aussichtslos	privativ
herrschaftslos	privativ
würdelos	privativ
unwürdig	privativ
langzeitarbeitslos	privativ
ausnahmslos	privativ
tonlos	privativ
leidenschaftslos	privativ
kulturlos	privativ
illusionslos	privativ
desillusioniert	privativ
gesetzlos	privativ
vogelfrei	privativ
furchtlos	privativ
angstlos	privativ
unerschrocken	privativ
fleischlos	privativ
vegetarisch	privativ
charakterlos	privativ
berufslos	privativ
bartlos	privativ
steuerlos	privativ
steuerfrei	privativ
schufafrei	privativ
reizlos	privativ
regellos	privativ
prinzipienlos	privativ
mitleidlos	privativ
geruchlos	privativ
führerlos	privativ
herrenlos	privativ
ehrlos	privativ
brotlos	privativ
absichtslos	privativ
substanzlos	privativ
stromlos	privativ
lichtlos	privativ
körperlos	privativ
konfliktlos	privativ
konfessionslos	privativ
komplikationslos	privativ
fugenlos	privativ
disziplinlos	privativ
vorurteilslos	privativ
vorurteilsfrei	privativ
verfassungslos	privativ
vaterlos	privativ
traumlos	privativ
stimmrechtslos	privativ
einflusslos	privativ
reglos	privativ
regungslos	privativ
fristlos	privativ
bewusstlos	privativ
schwanzlos	privativ
schattenlos	privativ
ruhmlos	privativ
randlos	privativ
pietätlos	privativ
gottlos	privativ
gestaltlos	privativ
geschlechtslos	privativ
führungslos	privativ
friedlos	privativ
fraglos	privativ
ereignislos	privativ
ehelos	privativ
diskussionslos	privativ
bedürfnislos	privativ
ausdruckslos	privativ
voraussetzungslos	privativ
spannungslos	privativ
schlackenlos	privativ
interesselos	privativ
interessenlos	privativ
hüllenlos	privativ
entschädigungslos	privativ
elternlos	privativ
bundfaltenlos	privativ
anstandslos	privativ
frei	privativ
einwandfrei	privativ
tadellos	privativ
spielfrei	privativ
gewaltfrei	privativ
kreisfrei	privativ
autofrei	privativ
straffrei	privativ
straflos	privativ
nicht alkoholisch	privativ
alkoholfrei	privativ
antialkoholisch	privativ
gebührenfrei	privativ
gebührenlos	privativ
verlustpunktfrei	privativ
niederschlagsfrei	privativ
wertfrei	privativ
rechtsfrei	privativ
verfolgungsfrei	privativ
rauchfrei	privativ
zollfrei	privativ
frostfrei	privativ
bleifrei	privativ
schuldenfrei	privativ
drogenfrei	privativ
schulfrei	privativ
hitzefrei	privativ
mietfrei	privativ
arbeitsfrei	privativ
blockfrei	privativ
hierarchiefrei	privativ
störungsfrei	privativ
störungslos	privativ
ungestört	privativ
schmerzfrei	privativ
unterrichtsfrei	privativ
stressfrei	privativ
sorgenfrei	privativ
konfliktfrei	privativ
keimfrei	privativ
angstfrei	privativ
sinnfrei	privativ
beschwerdefrei	privativ
beschwerdenfrei	privativ
atomwaffenfrei	privativ
rostfrei	privativ
jugendfrei	privativ
kinderfrei	privativ
akzentfrei	privativ
abgasfrei	privativ
ideologiefrei	privativ
vorlesungsfrei	privativ
schwindelfrei	privativ
rezeptfrei	privativ
beitragsfrei	privativ
risikofrei	privativ
nikotinfrei	privativ
werbefrei	privativ
wartungsfrei	privativ
kreuzungsfrei	privativ
dopingfrei	privativ
schneefrei	privativ
lösungsmittelfrei	privativ
eisfrei	privativ
umsteigefrei	privativ
schienenfrei	privativ
schadstofffrei	privativ
rückstandsfrei	privativ
regelfrei	privativ
müllfrei	privativ
genehmigungsfrei	privativ
zerstörungsfrei	privativ
zeilenfrei	privativ
wahlfrei	privativ
spannungsfrei	privativ
schadenfrei	privativ
regenfrei	privativ
herrschaftsfrei	privativ
chlorfrei	privativ
chemiefrei	privativ
verlustfrei	privativ
tilgungsfrei	privativ
textilfrei	privativ
machtfrei	privativ
kriegsfrei	privativ
ermüdungsfrei	privativ
dienstfrei	privativ
asbestfrei	privativ
zugfrei	privativ
weichmacherfrei	privativ
vortragsfrei	privativ
verkehrsfrei	privativ
verantwortungsfrei	privativ
holzfrei	privativ
tropenholzfrei	privativ
tabufrei	privativ
tabulos	privativ
tabakrauchfrei	privativ
staatsfrei	privativ
rußfrei	privativ
rauschfrei	privativ
portofrei	privativ
gemafrei	privativ
niederlagenfrei	privativ
mangelfrei	privativ
kalkfrei	privativ
inflationsfrei	privativ
giftfrei	privativ
flüchtlingsfrei	privativ
bündnisfrei	privativ
atomenergiefrei	privativ
ampelfrei	privativ
ölfrei	privativ
wissensfrei	privativ
wettbewerbsfrei	privativ
wasserfrei	privativ
waffenfrei	privativ
vorstellungsfrei	privativ
verschleißfrei	privativ
verletzungsfrei	privativ
trainingsfrei	privativ
sündenfrei	privativ
spesenfrei	privativ
sozialversicherungsfrei	privativ
sitzungsfrei	privativ
seifenfrei	privativ
schadensfrei	privativ
repressionsfrei	privativ
politikfrei	privativ
plastikfrei	privativ
phosphatfrei	privativ
pfändungsfrei	privativ
männerfrei	privativ
lösemittelfrei	privativ
lärmfrei	privativ
leistungsfrei	privativ
kündigungsfrei	privativ
kunstfrei	privativ
kriminalitätsfrei	privativ
kratzerfrei	privativ
korruptionsfrei	privativ
konzernfrei	privativ
konfrontationsfrei	privativ
kommunistenfrei	privativ
kohlendioxidfrei	privativ
knitterfrei	privativ
halbfrei	privativ
glaubensfrei	privativ
religionsfrei	privativ
gemeindefrei	privativ
frauenfrei	privativ
floskelfrei	privativ
flimmerfrei	privativ
fieberfrei	privativ
fettfrei	privativ
emotionsfrei	privativ
bügelfrei	privativ
berührungsfrei	privativ
barrierefrei	privativ
anrechnungsfrei	privativ
altlastenfrei	privativ
abzugsfrei	privativ
abgabefrei	privativ
abgabenfrei	privativ
leer	privativ
menschenleer	privativ
luftleer	privativ
halbleer	privativ
sinnleer	privativ
sinnentleert	privativ
blutleer	privativ
zweifellos	privativ
zweifelsfrei	privativ
herzlos	privativ
seelenlos	privativ
besitzlos	privativ
mittellos	privativ
grenzenlos	privativ
schrankenlos	privativ
nicht sesshaft	privativ
obdachlos	privativ
wohnungslos	privativ
torlos	privativ
nichtsahnend	privativ
laktovegetarisch	privativ
ovolaktovegetarisch	privativ
vegan	privativ
relationsspezifisch	Relation
geltungsspezifisch	Relation
gültig	Relation
immerwährend	Relation
geltend	Relation
allgemeingültig	Relation
universell	Relation
übertragbar	Relation
zulässig	Relation
erlaubt	Relation
gestattet	Relation
genehmigungsfähig	Relation
legal	Relation
gesetzlich	Relation
ungültig	Relation
unzulässig	Relation
verboten	Relation
unerlaubt	Relation
schwarz	Relation
unlauter	Relation
ungesetzlich	Relation
illegal	Relation
gesetzeswidrig	Relation
möglich	Relation
tolerabel	Relation
duldbar	Relation
verzeihlich	Relation
verzeihbar	Relation
entschuldbar	Relation
machbar	Relation
ausführbar	Relation
durchführbar	Relation
umsetzbar	Relation
realisierbar	Relation
verwirklichbar	Relation
praktikabel	Relation
handhabbar	Relation
beherrschbar	Relation
lösbar	Relation
auflösbar	Relation
behebbar	Relation
auflöslich	Relation
aufhebbar	Relation
unauflösbar	Relation
unauflöslich	Relation
unaufhebbar	Relation
unlösbar	Relation
unmöglich	Relation
unrealisierbar	Relation
undurchführbar	Relation
unbewältigbar	Relation
unüberwindlich	Relation
unüberwindbar	Relation
unbezwingbar	Relation
vereinbar	Relation
kompatibel	Relation
unvereinbar	Relation
inkompatibel	Relation
abhängig	Relation
unselbstständig	Relation
hilfsbedürftig	Relation
hilfebedürftig	Relation
hilfesuchend	Relation
anlehnungsbedürftig	Relation
pflegeabhängig	Relation
pflegebedürftig	Relation
abhängig	Relation
süchtig	Relation
drogenabhängig	Relation
drogensüchtig	Relation
rauschgiftsüchtig	Relation
alkoholabhängig	Relation
alkoholsüchtig	Relation
trunksüchtig	Relation
heroinsüchtig	Relation
heroinabhängig	Relation
kokainsüchtig	Relation
kokainabhängig	Relation
medikamentenabhängig	Relation
tablettensüchtig	Relation
sexsüchtig	Relation
fernsehsüchtig	Relation
internetsüchtig	Relation
kaufsüchtig	Relation
verschwendungssüchtig	Relation
spielsüchtig	Relation
arbeitssüchtig	Relation
workoholic	Relation
fresssüchtig	Relation
esssüchtig	Relation
unabhängig	Relation
selbstständig	Relation
restriktiv	Relation
einschränkend	Relation
eingeschränkt	Relation
beschränkend	Relation
beschränkt	Relation
kontrolliert	Relation
unkontrolliert	Relation
unbeschränkt	Relation
gewissheitsspezifisch	Relation
sicher	Relation
vorhersagbar	Relation
gewiss	Relation
bestimmt	Relation
unbestimmt	Relation
vorherbestimmt	Relation
determiniert	Relation
schicksalhaft	Relation
karmisch	Relation
ambivalent	Relation
zwiespältig	Relation
zweideutig	Relation
gespalten	Relation
zwielichtig	Relation
halbseiden	Relation
mehrdeutig	Relation
widersprüchlich	Relation
janusköpfig	Relation
doppeldeutig	Relation
vieldeutig	Relation
paradox	Relation
widersinnig	Relation
geklärt	Relation
bereinigt	Relation
denkbar	Relation
erdenklich	Relation
naheliegend	Relation
höchstwahrscheinlich	Relation
augenfällig	Relation
augenscheinlich	Relation
möglich	Relation
wahrscheinlich	Relation
unwahrscheinlich	Relation
unmöglich	Relation
unglaublich	Relation
haarsträubend	Relation
ungeheuer	Relation
unheimlich	Relation
ungeheuerlich	Relation
potenziell	Relation
mutmaßlich	Relation
anscheinend	Relation
vermutlich	Relation
voraussichtlich	Relation
erwartungsgemäß	Relation
erwartungsgetreu	Relation
eventuell	Relation
etwaig	Relation
spekulativ	Relation
hypothetisch	Relation
ungeklärt	Relation
offenbar	Relation
offensichtlich	Relation
offenkundig	Relation
sichtlich	Relation
ersichtlich	Relation
manifest	Relation
notorisch	Relation
allbekannt	Relation
ungeschrieben	Relation
eindeutig	Relation
unzweideutig	Relation
absehbar	Relation
vorhersehbar	Relation
vorstellbar	Relation
unvorhersehbar	Relation
unvorstellbar	Relation
undenkbar	Relation
unausdenkbar	Relation
ungewiss	Relation
scheinbar	Relation
endgültig	Relation
definitiv	Relation
unumstößlich	Relation
letztlich	Relation
letztendlich	Relation
unwiderruflich	Relation
unwiderrufbar	Relation
unwiederbringlich	Relation
irreparabel	Relation
irreversibel	Relation
unabänderlich	Relation
unabänderbar	Relation
unheilbar	Relation
unkurierbar	Relation
heilbar	Relation
kurierbar	Relation
unumkehrbar	Relation
reversibel	Relation
reparabel	Relation
korrigierbar	Relation
umkehrbar	Relation
veränderbar	Relation
modifizierbar	Relation
abschließend	Relation
bewiesen	Relation
widerlegt	Relation
erwiesen	Relation
bezeugt	Relation
nachweislich	Relation
nachweisbar	Relation
unbewiesen	Relation
bedarfsspezifisch	Relation
wichtig	Relation
benötigt	Relation
gebraucht	Relation
ungebraucht	Relation
unbenötigt	Relation
benutzt	Relation
genutzt	Relation
ungenutzt	Relation
unbenutzt	Relation
brachliegend	Relation
verpasst	Relation
verpaßt	Relation
vertan	Relation
versäumt	Relation
verkümmert	Relation
verschleudert	Relation
maßgebend	Relation
zielweisend	Relation
normativ	Relation
programmatisch	Relation
richtungsweisend	Relation
bedeutend	Relation
bedeutsam	Relation
bedeutungsvoll	Relation
signifikant	Relation
staatstragend	Relation
repräsentativ	Relation
aussagekräftig	Relation
aussagefähig	Relation
prägend	Relation
epochal	Relation
aufschlussreich	Relation
vielsagend	Relation
beredt	Relation
erwähnenswert	Relation
nennenswert	Relation
wichtigst	Relation
zweitwichtigst	Relation
unbedeutend	Relation
unbedeutsam	Relation
nebensächlich	Relation
zweitrangig	Relation
sekundär	Relation
drittrangig	Relation
tertiär	Relation
bemerkenswert	Relation
beachtlich	Relation
beachtbar	Relation
wesentlich	Relation
relevant	Relation
diskutabel	Relation
konsensfähig	Relation
bestimmend	Relation
charakteristisch	Relation
kennzeichnend	Relation
unverkennbar	Relation
unverwechselbar	Relation
bezeichnend	Relation
symptomatisch	Relation
verräterisch	Relation
entlarvend	Relation
indiskutabel	Relation
unmaßgeblich	Relation
irrelevant	Relation
unwesentlich	Relation
einschlägig	Relation
grundsätzlich	Relation
essenziell	Relation
maßgeblich	Relation
hauptsächlich	Relation
vorrangig	Relation
primär	Relation
schwerpunktmäßig	Relation
vorherrschend	Relation
herrschend	Relation
entscheidend	Relation
ausschlaggebend	Relation
auslösend	Relation
krebserregend	Relation
krebsauslösend	Relation
krass	Relation
gravierend	Relation
gewichtig	Relation
schwerwiegend	Relation
lebenswichtig	Relation
lebensnotwendig	Relation
existenziell	Relation
existenzial	Relation
unwichtig	Relation
zentral	Relation
marginal	Relation
beiläufig	Relation
lapidar	Relation
läppisch	Relation
nichtig	Relation
notwendig	Relation
erforderlich	Relation
unerlässlich	Relation
nötig	Relation
obligatorisch	Relation
optional	Relation
unverzichtbar	Relation
unbedingt	Relation
zwingend	Relation
unabdingbar	Relation
kategorisch	Relation
fällig	Relation
unvermeidbar	Relation
unvermeidlich	Relation
unweigerlich	Relation
zwangsläufig	Relation
notgedrungen	Relation
unaufhaltsam	Relation
unaufhaltbar	Relation
unumgänglich	Relation
unausweichlich	Relation
vermeidbar	Relation
überflüssig	Relation
unnütz	Relation
müßig	Relation
unnötig	Relation
verzichtbar	Relation
entbehrlich	Relation
grundlegend	Relation
elementar	Relation
fundamental	Relation
wirkungsspezifisch	Relation
fruchtbar	Relation
unfruchtbar	Relation
unwirtlich	Relation
übertragbar	Relation
ansteckend	Relation
infektiös	Relation
glückbringend	Relation
heilbringed	Relation
segensreich	Relation
segenspendend	Relation
segenbringend	Relation
wirksam	Relation
effektiv	Relation
medienwirksam	Relation
publikumswirksam	Relation
werbewirksam	Relation
wirkungsvoll	Relation
effizient	Relation
effektvoll	Relation
rechtskräftig	Relation
rechtsgültig	Relation
verurteilt	Relation
abgeurteilt	Relation
freigesprochen	Relation
beschuldigt	Relation
angeklagt	Relation
strafverfolgt	Relation
unwirksam	Relation
wirkungslos	Relation
ineffizient	Relation
mächtig	Relation
finanzstark	Relation
finanzkräftig	Relation
übermächtig	Relation
aufwandsspezifisch	Relation
vergeblich	Relation
umsonst	Relation
vergebens	Relation
schwer	Relation
mittelschwer	Relation
aufwendig	Relation
arbeitsreich	Relation
arbeitaufwändig	Relation
arbeitsintensiv	Relation
arbeitsaufwendig	Relation
zeitintensiv	Relation
zeitraubend	Relation
zeitaufwendig	Relation
schwierig	Relation
diffizil	Relation
problematisch	Relation
problemvoll	Relation
brisant	Relation
brenzlig	Relation
knifflig	Relation
heikel	Relation
prekär	Relation
kompliziert	Relation
komplex	Relation
vielschichtig	Relation
verwickelt	Relation
verworren	Relation
verwoben	Relation
hart	Relation
mühevoll	Relation
anstrengend	Relation
stressig	Relation
schweißtreibend	Relation
mühsam	Relation
mühselig	Relation
beschwerlich	Relation
verzwickt	Relation
vertrackt	Relation
verzwackt	Relation
verflixt	Relation
verflucht	Relation
vermaledeit	Relation
undurchschaubar	Relation
unüberprüfbar	Relation
unkontrollierbar	Relation
kontrollierbar	Relation
leicht	Relation
einfach	Relation
schlicht	Relation
trivial	Relation
banal	Relation
unschwer	Relation
platt	Relation
feil	Relation
wohlfeil	Relation
flach	Relation
seicht	Relation
dümmlich	Relation
problemlos	Relation
problemfrei	Relation
unproblematisch	Relation
reibungslos	Relation
mühelos	Relation
simpel	Relation
primitiv	Relation
durchschaubar	Relation
durchsichtig	Relation
verständlich	Relation
sinnfällig	Relation
unverständlich	Relation
unbegreiflich	Relation
unbegreifbar	Relation
unerfindlich	Relation
unergründlich	Relation
unfassbar	Relation
fassbar	Relation
einleuchtend	Relation
erfassbar	Relation
messbar	Relation
nachmessbar	Relation
nachvollziehbar	Relation
begreifbar	Relation
begreiflich	Relation
erklärlich	Relation
erklärbar	Relation
einsehbar	Relation
überprüfbar	Relation
nachprüfbar	Relation
beweisbar	Relation
beschreibbar	Relation
unbeschreiblich	Relation
unbeschreibbar	Relation
unsäglich	Relation
unerklärlich	Relation
unerklärbar	Relation
zugänglich	Relation
offen	Relation
frei	Relation
ungehindert	Relation
unbehindert	Relation
betretbar	Relation
begehbar	Relation
befahrbar	Relation
passierbar	Relation
gesperrt	Relation
versperrt	Relation
unpassierbar	Relation
sparsam	Relation
ökonomisch	Relation
wirtschaftlich	Relation
rentabel	Relation
profitabel	Relation
zinsgünstig	Relation
spartanisch	Relation
karg	Relation
energiesparend	Relation
effizient	Relation
kräftesparend	Relation
kostensparend	Relation
kostendämpfend	Relation
unökonomisch	Relation
unwirtschaftlich	Relation
ineffizient	Relation
unrentabel	Relation
behandlungsspezifisch	Relation
medizinisch	Relation
telemedizinisch	Relation
pflegerisch	Relation
pharmazeutisch	Relation
psychosomatisch	Relation
geriatrisch	Relation
stationär	Relation
ambulant	Relation
funktionalitätsspezifisch	Relation
funktional	Relation
multifunktional	Relation
polyfunktional	Relation
intakt	Relation
ganz	Relation
unbeschädigt	Relation
funktionstüchtig	Relation
funktionsfähig	Relation
defekt	Relation
kaputt	Relation
beschädigt	Relation
zerissen	Relation
eingefallen	Relation
abgegriffen	Relation
abgewirtschaftet	Relation
heruntergewirtschaftet	Relation
austauschbar	Relation
ersetzbar	Relation
unersetzbar	Relation
unersetzlich	Relation
unabkömmlich	Relation
unentbehrlich	Relation
vernichtet	Relation
zerstört	Relation
zerrüttet	Relation
zerlöchert	Relation
perforiert	Relation
erweiterbar	Relation
ausbaufähig	Relation
erneuerbar	Relation
renovierbar	Relation
instandsetzbar	Relation
verwertbar	Relation
brauchbar	Relation
nutzbar	Relation
abbaubar	Relation
erschließbar	Relation
zugreifbar	Relation
abrufbar	Relation
unbrauchbar	Relation
sicherheitsspezifisch	Relation
gefährlich	Relation
riskant	Relation
risikoreich	Relation
gefährdend	Relation
gesundheitsgefährdend	Relation
sicherheitsgefährdend	Relation
friedensgefährdend	Relation
gewagt	Relation
tödlich	Relation
lebensgefährlich	Relation
lebensbedrohlich	Relation
sicher	Relation
ungefährlich	Relation
geschützt	Relation
abgeschirmt	Relation
denkmalgeschützt	Relation
ungeschützt	Relation
ungesichert	Relation
bedroht	Relation
gefährdet	Relation
harmlos	Relation
zuverlässig	Relation
stabil	Relation
hart	Relation
ordnungsspezifisch	Relation
geordnet	Relation
zeitlich geordnet	Relation
chronologisch	Relation
sortiert	Relation
gruppiert	Relation
übersichtlich	Relation
überschaubar	Relation
ordentlich	Relation
säuberlich	Relation
ungeordnet	Relation
wirr	Relation
unübersichtlich	Relation
unüberschaubar	Relation
unabsehbar	Relation
chaotisch	Relation
babylonisch	Relation
unordentlich	Relation
symmetrisch	Relation
asymmetrisch	Relation
gemischt	Relation
vermischt	Relation
verknüpfungsspezifisch	Relation
lose	Relation
los	Relation
unbefestigt	Relation
befestigt	Relation
festgebunden	Relation
angebunden	Relation
jeweilig	Relation
respektiv	Relation
zugehörig	Relation
angehörig	Relation
angehörend	Relation
seelenverwandt	Relation
wahlverwandt	Relation
befreundet	Relation
nahestehend	Relation
verbrüdert	Relation
verkumpelt	Relation
verwandt	Relation
blutsverwandt	Relation
verschwistert	Relation
verschwägert	Relation
beteiligt	Relation
verwickelt	Relation
involviert	Relation
betroffen	Relation
unbeteiligt	Relation
außenstehend	Relation
unbelastet	Relation
unbehelligt	Relation
ausgeschlossen	Relation
einbezogen	Relation
integriert	Relation
dazugehörig	Relation
miteinbezogen	Relation
inklusiv	Relation
einschließlich	Relation
berücksichtigt	Relation
stattgegeben	Relation
zusammengehörig	Relation
gepoolt	Relation
zusammengefasst	Relation
untrennbar	Relation
trennbar	Relation
leiblich	Relation
ureigen	Relation
ureigenst	Relation
eigen	Relation
körpereigen	Relation
körperimmanent	Relation
hauseigen	Relation
bundeseigen	Relation
landeseigen	Relation
staatseigen	Relation
volkseigen	Relation
dick	Relation
unzertrennbar	Relation
unzertrennlich	Relation
parteizugehörig	Relation
zusammenhängend	Relation
verbunden	Relation
assoziativ	Relation
verpflichtend	Relation
verbindlich	Relation
bindend	Relation
zusammen	Relation
gemeinsam	Relation
synchron	Relation
paarweise	Relation
scharenweise	Relation
gesamt	Relation
gemeinschaftlich	Relation
kollektiv	Relation
kooperativ	Relation
vereint	Relation
vereinigt	Relation
zusammengeschlossen	Relation
solidarisch	Relation
alliiert	Relation
verbündet	Relation
verschworen	Relation
einträchtig	Relation
allein	Relation
einzeln	Relation
vereinzelt	Relation
alleinstehend	Relation
verwaist	Relation
einzelstehend	Relation
freistehend	Relation
einzig	Relation
alleinig	Relation
ausschließlich	Relation
exklusiv	Relation
gegenseitig	Relation
wechselseitig	Relation
bilateral	Relation
beiderseitig	Relation
multilateral	Relation
polylateral	Relation
dual	Relation
zweiheitlich	Relation
einseitig	Relation
eingleisig	Relation
unilateral	Relation
mehrseitig	Relation
beidseitig	Relation
gegnerisch	Relation
oppositionell	Relation
konträr	Relation
subversiv	Relation
umstürzlerisch	Relation
umstürzend	Relation
gegensätzlich	Relation
entgegengesetzt	Relation
gegenteilig	Relation
gleichheitsspezifisch	Relation
verschieden	Relation
ungleich	Relation
divers	Relation
verschiedenartig	Relation
unähnlich	Relation
ander	Relation
anderweitig	Relation
unterschiedlich	Relation
unterscheidbar	Relation
zweierlei	Relation
wechselnd	Relation
abwechselnd	Relation
besonder	Relation
einzigartig	Relation
einmalig	Relation
bevorzugt	Relation
privilegiert	Relation
begünstigt	Relation
präferiert	Relation
priorisiert	Relation
vorteilhaft	Relation
nachteilig	Relation
depriviert	Relation
benachteiligt	Relation
entrechtet	Relation
entmündigt	Relation
enterbt	Relation
sonstig	Relation
gleich	Relation
gleichartig	Relation
identisch	Relation
homogen	Relation
heterogen	Relation
übereinstimmend	Relation
übereinkommend	Relation
deckungsgleich	Relation
gleichwertig	Relation
ebenbürtig	Relation
gleichnamig	Relation
gleichaltrig	Relation
gleichalt	Relation
gleichberechtigt	Relation
gleichgestellt	Relation
paritätisch	Relation
vollwertig	Relation
gleichgesinnt	Relation
gleichrangig	Relation
gleichbedeutend	Relation
gleichgeschaltet	Relation
nivelliert	Relation
punktgleich	Relation
unentschieden	Relation
ähnlich	Relation
vergleichbar	Relation
parallel	Relation
selb	Relation
nämlich	Relation
entsprechend	Relation
analog	Relation
dementsprechend	Relation
demgemäß	Relation
passend	Relation
treffend	Relation
zutreffend	Relation
trefflich	Relation
maßgeschneidert	Relation
maßgerecht	Relation
naturgetreu	Relation
kindgerecht	Relation
kindgemäß	Relation
kindgetreu	Relation
artgerecht	Relation
artgemäß	Relation
stimmig	Relation
abgestimmt	Relation
allgemein	Relation
generell	Relation
beliebig	Relation
pauschal	Relation
speziell	Relation
spezial	Relation
spezifisch	Relation
individuell	Relation
einstimmig	Relation
harmonisch	Relation
einmütig	Relation
einig	Relation
einverstanden	Relation
uneins	Relation
uneinig	Relation
genauigkeitsspezifisch	Relation
genau	Relation
präzise	Relation
präzis	Relation
kleinlich	Relation
übergenau	Relation
pingelig	Relation
minutiös	Relation
exakt	Relation
akkurat	Relation
haargenau	Relation
sorgfältig	Relation
eingehend	Relation
geplant	Relation
durchdacht	Relation
organisiert	Relation
verwaltet	Relation
vorsätzlich	Relation
gezielt	Relation
abgezielt	Relation
vorgesehen	Relation
planmäßig	Relation
plangemäß	Relation
vorbereitet	Relation
unvorbereitet	Relation
ungeplant	Relation
planerisch	Relation
strategisch	Relation
operativ	Relation
operativ	Relation
taktisch	Relation
wörtlich	Relation
wortwörtlich	Relation
messerscharf	Relation
klar	Relation
glasklar	Relation
ungenau	Relation
unklar	Relation
verschwommen	Relation
nebulös	Relation
schwammig	Relation
missverständlich	Relation
diffus	Relation
undurchsichtig	Relation
vage	Relation
vag	Relation
ungefähr	Relation
abgerundet	Relation
aufgerundet	Relation
gerundet	Relation
annähernd	Relation
approximativ	Relation
unscharf	Relation
vollständigkeitsspezifisch	Relation
vollständig	Relation
komplett	Relation
vollzählig	Relation
abgeschlossen	Relation
vollendet	Relation
vollzogen	Relation
durchgezogen	Relation
durchgeführt	Relation
vollbracht	Relation
getan	Relation
erledigt	Relation
abgelehnt	Relation
angenommen	Relation
akzeptiert	Relation
zurückgewiesen	Relation
abgewimmelt	Relation
abgewiesen	Relation
abgehakt	Relation
entschieden	Relation
eingestellt	Relation
flächendeckend	Relation
kostendeckend	Relation
unvollendet	Relation
liegen geblieben	Relation
unerledigt	Relation
unentschieden	Relation
ungelöst	Relation
unaufgelöst	Relation
unabgeschlossen	Relation
offen	Relation
offen stehend	Relation
offen geblieben	Relation
offen gelassen	Relation
aufgeteilt	Relation
zerteilt	Relation
zweigeteilt	Relation
geschnitten	Relation
geschnetzelt	Relation
zerschnitten	Relation
zersäbelt	Relation
zerfasert	Relation
zerkleinert	Relation
integer	Relation
ungeteilt	Relation
unzerteilt	Relation
ganz	Relation
restlos	Relation
integral	Relation
ganzheitlich	Relation
unteilbar	Relation
absolut	Relation
gänzlich	Relation
völlig	Relation
total	Relation
vollkommen	Relation
verdammt	Relation
ziemlich	Relation
gewiss	Relation
bereit	Relation
fertig	Relation
bezugsfertig	Relation
beziehbar	Relation
schlüsselfertig	Relation
startklar	Relation
startfertig	Relation
dienstbereit	Relation
einsatzbereit	Relation
lückenhaft	Relation
unvollständig	Relation
mangelhaft	Relation
unvollkommen	Relation
defizitär	Relation
notdürftig	Relation
notbehelfsmäßig	Relation
halb	Relation
rudimentär	Relation
fragmentarisch	Relation
bruchstückhaft	Relation
bruchstückartig	Relation
anteilig	Relation
fünfzigprozentig	Relation
zwanzigprozentig	Relation
dreißigprozentig	Relation
zehnprozentig	Relation
achtzigprozentig	Relation
sechzigprozentig	Relation
siebzigprozentig	Relation
neunzigprozentig	Relation
hundertprozentig	Relation
teilweise	Relation
partiell	Relation
vergleichsweise	Relation
relativ	Relation
verhältnismäßig	Relation
bezugspezifisch	Relation
besagt	Relation
direkt	Relation
unmittelbar	Relation
unvermittelt	Relation
unverwässert	Relation
schier	Relation
pur	Relation
bar	Relation
cash	Relation
bargeldlos	Relation
unbar	Relation
wörtlich	Relation
ausdrücklich	Relation
explizit	Relation
buchstäblich	Relation
sprichwörtlich	Relation
nachdrücklich	Relation
eindringlich	Relation
inständig	Relation
unmissverständlich	Relation
absichtlich	Relation
absichtsvoll	Relation
willentlich	Relation
beabsichtigt	Relation
mutwillig	Relation
leichtfertig	Relation
unabsichtlich	Relation
unbeabsichtigt	Relation
unwillkürlich	Relation
versehentlich	Relation
zufällig	Relation
indirekt	Relation
mittelbar	Relation
bezüglich	Relation
diesbezüglich	Relation
symbolhaft	Relation
symbolisch	Relation
kodiert	Relation
verschlüsselt	Relation
digital	Relation
analog	Relation
übertragen	Relation
implizit	Relation
konkret	Relation
anschaulich	Relation
abstrakt	Relation
ausstattungsspezifisch	Relation
ausgestattet	Relation
versehen	Relation
ausgerüstet	Relation
gedeckt	Relation
beladen	Relation
vollgeladen	Relation
überladen	Relation
überfrachtet	Relation
bedeckt	Relation
zugedeckt	Relation
asphaltiert	Relation
begrünt	Relation
schneebedeckt	Relation
überzuckert	Relation
überbacken	Relation
zuträglichkeitsspezifisch	Relation
schädlich	Relation
abträglich	Relation
schädigend	Relation
kontraproduktiv	Relation
unverträglich	Relation
giftig	Relation
hochgiftig	Relation
radioaktiv	Relation
strahlend	Relation
gesundheitsschädlich	Relation
gesundheitsschädigend	Relation
nervenschädlich	Relation
nervenschädigend	Relation
leberschädlich	Relation
leberschädigend	Relation
nierenschädlich	Relation
nierenschädigend	Relation
augenschädlich	Relation
augenschädigend	Relation
umweltschädlich	Relation
umweltschädigend	Relation
klimaschädlich	Relation
klimaschädigend	Relation
ozonschädlich	Relation
ozonschädigend	Relation
parteischädigend	Relation
geschäftsschädigend	Relation
rufschädigend	Relation
verträglich	Relation
zuträglich	Relation
unschädlich	Relation
unbedenklich	Relation
heilsam	Relation
heilend	Relation
probiotisch	Relation
antibiotisch	Relation
wohltuend	Relation
ungiftig	Relation
essbar	Relation
genießbar	Relation
bekömmlich	Relation
verdaulich	Relation
unessbar	Relation
nicht essbar	Relation
ungenießbar	Relation
unbekömmlich	Relation
umweltverträglich	Relation
naturverträglich	Relation
landschaftsverträglich	Relation
klimaverträglich	Relation
pflanzenverträglich	Relation
sozialverträglich	Relation
wirtschaftsverträglich	Relation
konjunkturverträglich	Relation
gesellschaftsverträglich	Relation
menschenverträglich	Relation
stadtverträglich	Relation
gesund	Relation
gesundheitsverträglich	Relation
magenverträglich	Relation
hautverträglich	Relation
verwendet	Relation
angeordnet	Relation
angeordnet	Relation
gehörend	Relation
wirkend	Relation
gesammelt	Relation
erfolgt	Relation
vereinfacht	Relation
strukturiert	Relation
übergeordnet	Relation
kleingeschnitten	Relation
kleinstrukturiert	Relation
nicht trivial	Relation
nicht selbstständig	Relation
nicht benötigt	Relation
nicht tödlich	Relation
nicht bundeseigen	Relation
nicht medizinisch	Relation
nicht kooperativ	Relation
nicht organisiert	Relation
nicht übertragbar	Relation
nicht verwandt	Relation
schuppenartig	Relation
ausnahmslos	Relation
uneingeschränkt	Relation
beispiellos	Relation
unvergleichlich	Relation
unvergleichbar	Relation
scharf	Relation
nicht relevant	Relation
maßhaltig	Relation
symbolhaltig	Relation
vorstehend	Relation
ausstehend	Relation
untergeordnet	Relation
unterstehend	Relation
bereitstehend	Relation
weisend	Relation
zweiseitig	Relation
beweisend	Relation
auszugsweise	Relation
substanzspezifisch	Substanz
beschaffenheitsspezifisch	Substanz
seiden	Substanz
hölzern	Substanz
rinden	Substanz
krautig	Substanz
eisern	Substanz
ehern	Substanz
metallen	Substanz
stählern	Substanz
blechern	Substanz
golden	Substanz
silbern	Substanz
bleiern	Substanz
kupfern	Substanz
bronzen	Substanz
gläsern	Substanz
steinern	Substanz
kristallen	Substanz
kristallin	Substanz
ledern	Substanz
krachledern	Substanz
wollen	Substanz
aschen	Substanz
tönern	Substanz
metallisch	Substanz
dick	Substanz
mehrschichtig	Substanz
dicklagig	Substanz
wattiert	Substanz
grob	Substanz
dicht	Substanz
undurchsichtig	Substanz
dünn	Substanz
fein	Substanz
fragil	Substanz
zerbrechlich	Substanz
filigran	Substanz
haardünn	Substanz
hauchdünn	Substanz
naturbelassen	Substanz
künstlich	Substanz
artifiziell	Substanz
unnatürlich	Substanz
synthetisch	Substanz
derartig	Substanz
dergestalt	Substanz
expansiv	Substanz
ausdehnbar	Substanz
explosiv	Substanz
entzündbar	Substanz
fossil	Substanz
versteinert	Substanz
petrifiziert	Substanz
produktspezifisch	Substanz
selbstgemacht	Substanz
selbstgebaut	Substanz
hausgemacht	Substanz
manuell	Substanz
händisch	Substanz
selbstgebastelt	Substanz
selbstgenäht	Substanz
selbstgestrickt	Substanz
selbstgekocht	Substanz
künstlich erzeugt	Substanz
maschinell gefertigt	Substanz
zustandsspezifisch	Substanz
offen	Substanz
geöffnet	Substanz
geschlossen	Substanz
verschlossen	Substanz
roh	Substanz
gekocht	Substanz
durch	Substanz
medium	Substanz
halbdurch	Substanz
halbgar	Substanz
stabilitätsspezifisch	Substanz
stabil	Substanz
robust	Substanz
kochfest	Substanz
wetterfest	Substanz
hitzebeständig	Substanz
kältebeständig	Substanz
unstabil	Substanz
instabil	Substanz
desolat	Substanz
dicht	Substanz
undurchlässig	Substanz
luftdicht	Substanz
wasserdicht	Substanz
luft- und wasserdicht	Substanz
hermetisch	Substanz
undicht	Substanz
durchlässig	Substanz
leck	Substanz
löchrig	Substanz
marode	Substanz
marod	Substanz
baufällig	Substanz
rostig	Substanz
verrostet	Substanz
verwittert	Substanz
wackelig	Substanz
wacklig	Substanz
konsistenzspezifisch	Substanz
fest	Substanz
hart	Substanz
solid	Substanz
fest	Substanz
stramm	Substanz
locker	Substanz
hohl	Substanz
klebrig	Substanz
plastisch	Substanz
formbar	Substanz
modellierbar	Substanz
knetbar	Substanz
saftig	Substanz
festkochend	Substanz
mehlig	Substanz
porös	Substanz
fluffig	Substanz
brüchig	Substanz
schlabbrig	Substanz
schlabberig	Substanz
morsch	Substanz
mürb	Substanz
mürbe	Substanz
lose	Substanz
los	Substanz
flüssig	Substanz
dünnflüssig	Substanz
zähflüssig	Substanz
zäh	Substanz
dick	Substanz
dickflüssig	Substanz
matschig	Substanz
schlammig	Substanz
schleimig	Substanz
sämig	Substanz
geronnen	Substanz
eingedickt	Substanz
klumpig	Substanz
klümperig	Substanz
klümprig	Substanz
dünn	Substanz
faserig	Substanz
fasrig	Substanz
holzig	Substanz
weich	Substanz
moorig	Substanz
biegsam	Substanz
reifespezifisch	Substanz
frisch	Substanz
knackig	Substanz
knusprig	Substanz
reif	Substanz
überreif	Substanz
matschig	Substanz
verdorben	Substanz
faul	Substanz
verfault	Substanz
faulig	Substanz
verschimmelt	Substanz
schimmelig	Substanz
verrottet	Substanz
verfallen	Substanz
abgelaufen	Substanz
unreif	Substanz
grün	Substanz
obergärig	Substanz
untergärig	Substanz
feuchtigkeitsspezifisch	Substanz
trocken	Substanz
ausgetrocknet	Substanz
nass	Substanz
naß	Substanz
feucht	Substanz
klamm	Substanz
sumpfig	Substanz
reinheitsspezifisch	Substanz
rein	Substanz
pur	Substanz
koscher	Substanz
unrein	Substanz
verunreinigt	Substanz
verschmutzt	Substanz
unhygienisch	Substanz
hygienisch	Substanz
keimfrei	Substanz
steril	Substanz
lupenrein	Substanz
verpanscht	Substanz
gepanscht	Substanz
verseucht	Substanz
kontaminiert	Substanz
schmutzig	Substanz
dreckig	Substanz
verdreckt	Substanz
beschmutzt	Substanz
staubig	Substanz
verstaubt	Substanz
verrußt	Substanz
rußig	Substanz
ungefiltert	Substanz
unsauber	Substanz
trüb	Substanz
fleckig	Substanz
schwarz	Substanz
sauber	Substanz
klar	Substanz
gefiltert	Substanz
absolut	Substanz
gewichtsspezifisch	Substanz
schwer	Substanz
leicht	Substanz
massiv	Substanz
federleicht	Substanz
luftig	Substanz
physikspezifisch	Substanz
elektrisch	Substanz
magnetisch	Substanz
elektromagnetisch	Substanz
radioaktiv	Substanz
chemiespezifisch	Substanz
kalkhaltig	Substanz
hart	Substanz
organisch	Substanz
anorganisch	Substanz
asbesthaltig	Substanz
dioxinhaltig	Substanz
ölhaltig	Substanz
alkoholhaltig	Substanz
metallhaltig	Substanz
schwermetallhaltig	Substanz
quecksilberhaltig	Substanz
uranhaltig	Substanz
plutoniumhaltig	Substanz
bleihaltig	Substanz
eisenhaltig	Substanz
edelmetallhaltig	Substanz
silberhaltig	Substanz
goldhaltig	Substanz
palladiumhaltig	Substanz
schwefelhaltig	Substanz
salzhaltig	Substanz
nährstoffhaltig	Substanz
zuckerhaltig	Substanz
fetthaltig	Substanz
vitaminhaltig	Substanz
eiweißhaltig	Substanz
fleischhaltig	Substanz
mineralstoffhaltig	Substanz
eisenhaltig	Substanz
wasserhaltig	Substanz
phosphathaltig	Substanz
stickstoffhaltig	Substanz
sauerstoffhaltig	Substanz
sauerstoffarm	Substanz
stickig	Substanz
halogenhaltig	Substanz
chlorhaltig	Substanz
bromhaltig	Substanz
säurehaltig	Substanz
kohlensäurehaltig	Substanz
koffeinhaltig	Substanz
halluzinogenhaltig	Substanz
lösungsmittelhaltig	Substanz
lehmhaltig	Substanz
holzhaltig	Substanz
anabolikahaltig	Substanz
temperaturspezifisch	Substanz
warm	Substanz
heiß	Substanz
lau	Substanz
lauwarm	Substanz
kalt	Substanz
kühl	Substanz
eisig	Substanz
eiskalt	Substanz
eisigkalt	Substanz
biogen	Substanz
eröffnet	Substanz
eingelegt	Substanz
lederartig	Substanz
gallertartig	Substanz
grasartig	Substanz
wachsartig	Substanz
glasartig	Substanz
hornartig	Substanz
gummiartig	Substanz
pestverseucht	Substanz
papierartig	Substanz
schwammartig	Substanz
samtartig	Substanz
nicht metallisch	Substanz
nicht magnetisch	Substanz
nicht natürlich	Substanz
nicht nuklear	Substanz
brennbar	Substanz
nicht brennbar	Substanz
gelartig	Substanz
natürlich	Substanz
kupferhaltig	Substanz
kohlenstoffhaltig	Substanz
arsenhaltig	Substanz
iodhaltig	Substanz
jodhaltig	Substanz
proteinhaltig	Substanz
mineralhaltig	Substanz
kristallwasserhaltig	Substanz
quarzhaltig	Substanz
manganhaltig	Substanz
wasserstoffhaltig	Substanz
THC-haltig	Substanz
lufthaltig	Substanz
radiumhaltig	Substanz
erzhaltig	Substanz
phosphorhaltig	Substanz
karbonathaltig	Substanz
carbonathaltig	Substanz
kieselsäurehaltig	Substanz
schwefelsäurehaltig	Substanz
tellurhaltig	Substanz
kieshaltig	Substanz
gashaltig	Substanz
nikotinhaltig	Substanz
nicotinhaltig	Substanz
sulfidhaltig	Substanz
schadstoffhaltig	Substanz
blausäurehaltig	Substanz
elektrolythaltig	Substanz
salpeterhaltig	Substanz
Vitamin-C-haltig	Substanz
alkalihaltig	Substanz
chininhaltig	Substanz
kreidehaltig	Substanz
schieferhaltig	Substanz
leichtmetallhaltig	Substanz
aluminiumhaltig	Substanz
gadoliniumhaltig	Substanz
borhaltig	Substanz
kochsalzhaltig	Substanz
kollagenhaltig	Substanz
eisenerzhaltig	Substanz
kohlehaltig	Substanz
hochgoldhaltig	Substanz
PCB-haltig	Substanz
FCKW-haltig	Substanz
insektizidhaltig	Substanz
geruchsstoffhaltig	Substanz
salzsäurehaltig	Substanz
chromathaltig	Substanz
formaldehydhaltig	Substanz
muschelkalkhaltig	Substanz
acetylsalicylsäurehaltig	Substanz
nitrathaltig	Substanz
triclosanhaltig	Substanz
fenetyllinhaltig	Substanz
teerhaltig	Substanz
hämhaltig	Substanz
phosphorsäurehaltig	Substanz
suchtgifthaltig	Substanz
ethanolhaltig	Substanz
kohlendioxidhaltig	Substanz
fruchtzuckerhaltig	Substanz
harnstoffhaltig	Substanz
benzylbenzoathaltig	Substanz
übergangsmetallhaltig	Substanz
titanhaltig	Substanz
magnesiumsalzhaltig	Substanz
teerölhaltig	Substanz
docosahexaensäurehaltig	Substanz
calciumhaltig	Substanz
salzwasserhaltig	Substanz
nickelsalzhaltig	Substanz
verhaltensspezifisch	Verhalten
charakterspezifisch	Verhalten
weiblich	Verhalten
feminin	Verhalten
frauenhaft	Verhalten
fraulich	Verhalten
männlich	Verhalten
maskulin	Verhalten
androgyn	Verhalten
lieb	Verhalten
liebevoll	Verhalten
liebesfähig	Verhalten
zärtlich	Verhalten
gütig	Verhalten
gnädig	Verhalten
verzeihend	Verhalten
liebenswert	Verhalten
liebenswürdig	Verhalten
niedlich	Verhalten
putzig	Verhalten
goldig	Verhalten
knuffig	Verhalten
possierlich	Verhalten
süß	Verhalten
drollig	Verhalten
gerecht	Verhalten
fair	Verhalten
sportlich	Verhalten
tugendhaft	Verhalten
tugendlich	Verhalten
rechtschaffen	Verhalten
redlich	Verhalten
ehrlich	Verhalten
ehrenhaft	Verhalten
ehrenwert	Verhalten
achtbar	Verhalten
hehr	Verhalten
erhaben	Verhalten
verehrungswürdig	Verhalten
glorreich	Verhalten
ruhmvoll	Verhalten
ruhmreich	Verhalten
löblich	Verhalten
lobenswert	Verhalten
rühmlich	Verhalten
unrühmlich	Verhalten
tadelnswert	Verhalten
sträflich	Verhalten
glänzend	Verhalten
glanzvoll	Verhalten
furios	Verhalten
honett	Verhalten
honorabel	Verhalten
würdevoll	Verhalten
würdig	Verhalten
seriös	Verhalten
ernsthaft	Verhalten
gesetzt	Verhalten
abgeklärt	Verhalten
distinguiert	Verhalten
gediegen	Verhalten
solide	Verhalten
reputierlich	Verhalten
integer	Verhalten
charakterfest	Verhalten
standhaft	Verhalten
unbescholten	Verhalten
lauter	Verhalten
objektiv	Verhalten
sachlich	Verhalten
unvoreingenommen	Verhalten
vorurteilsfrei	Verhalten
nüchtern	Verhalten
unbestechlich	Verhalten
unparteiisch	Verhalten
neutral	Verhalten
vorbestraft	Verhalten
vorbelastet	Verhalten
vermurkst	Verhalten
verkorkst	Verhalten
belastet	Verhalten
beeinträchtigt	Verhalten
angeschlagen	Verhalten
gebeutelt	Verhalten
ramponiert	Verhalten
unterentwickelt	Verhalten
retardiert	Verhalten
zurückgeblieben	Verhalten
unehrenhaft	Verhalten
ehrlos	Verhalten
unwürdig	Verhalten
würdelos	Verhalten
nieder	Verhalten
niedrig	Verhalten
boshaft	Verhalten
niederträchtig	Verhalten
böse	Verhalten
maliziös	Verhalten
hämisch	Verhalten
süffisant	Verhalten
teuflisch	Verhalten
diabolisch	Verhalten
dämonisch	Verhalten
satanisch	Verhalten
gemein	Verhalten
stiefmütterlich	Verhalten
hasserfüllt	Verhalten
böswillig	Verhalten
bösartig	Verhalten
entwürdigend	Verhalten
schnöde	Verhalten
zerstörerisch	Verhalten
destruktiv	Verhalten
hinderlich	Verhalten
störend	Verhalten
selbstzerstörerisch	Verhalten
selbstschädigend	Verhalten
übelwollend	Verhalten
übel gesinnt	Verhalten
mies	Verhalten
fies	Verhalten
schadenfroh	Verhalten
schwarz	Verhalten
hinterhältig	Verhalten
feige	Verhalten
infam	Verhalten
hinterfotzig	Verhalten
durchtrieben	Verhalten
hinterlistig	Verhalten
arglistig	Verhalten
heimtückisch	Verhalten
tückisch	Verhalten
perfide	Verhalten
übel	Verhalten
ungerecht	Verhalten
unfair	Verhalten
unsportlich	Verhalten
subjektiv	Verhalten
voreingenommen	Verhalten
parteiisch	Verhalten
tendenziös	Verhalten
rechtslastig	Verhalten
linkslastig	Verhalten
kriminell	Verhalten
räuberisch	Verhalten
betrügerisch	Verhalten
strafbar	Verhalten
straffällig	Verhalten
delinquent	Verhalten
bestechlich	Verhalten
korrupt	Verhalten
käuflich	Verhalten
schuldig	Verhalten
mitschuldig	Verhalten
unschuldig	Verhalten
verbrecherisch	Verhalten
schändlich	Verhalten
brutal	Verhalten
gewalttätig	Verhalten
tätlich	Verhalten
militant	Verhalten
asozial	Verhalten
dissozial	Verhalten
gesellschaftsunfähig	Verhalten
gemeinschaftsschädigend	Verhalten
hart	Verhalten
harsch	Verhalten
rüde	Verhalten
knallhart	Verhalten
beinhart	Verhalten
eisenhart	Verhalten
schonungslos	Verhalten
gnadenlos	Verhalten
erbarmungslos	Verhalten
mitleidslos	Verhalten
grausam	Verhalten
barbarisch	Verhalten
martialisch	Verhalten
brachial	Verhalten
handgreiflich	Verhalten
blutrünstig	Verhalten
bestialisch	Verhalten
unmenschlich	Verhalten
menschenverachtend	Verhalten
inhuman	Verhalten
menschenunwürdig	Verhalten
kaltblütig	Verhalten
kaltschnäuzig	Verhalten
abgezockt	Verhalten
seelenruhig	Verhalten
hartgesotten	Verhalten
abgebrüht	Verhalten
ausgekocht	Verhalten
ausgebufft	Verhalten
raffiniert	Verhalten
rabiat	Verhalten
roh	Verhalten
fleißig	Verhalten
tüchtig	Verhalten
arbeitsam	Verhalten
emsig	Verhalten
eifrig	Verhalten
geschäftstüchtig	Verhalten
lebenstüchtig	Verhalten
untüchtig	Verhalten
lebensuntüchtig	Verhalten
unproduktiv	Verhalten
übereifrig	Verhalten
beflissen	Verhalten
diensteifrig	Verhalten
servil	Verhalten
eilfertig	Verhalten
faul	Verhalten
geschäftig	Verhalten
betriebsam	Verhalten
agil	Verhalten
tatkräftig	Verhalten
aktiv	Verhalten
produktiv	Verhalten
einflussnehmend	Verhalten
beeinflussend	Verhalten
missionarisch	Verhalten
aufklärerisch	Verhalten
suggestiv	Verhalten
meinungsbildend	Verhalten
meinungsmachend	Verhalten
propagandistisch	Verhalten
unternehmungslustig	Verhalten
freizeitorientiert	Verhalten
vergnügungsorientiert	Verhalten
experimentierfreudig	Verhalten
findig	Verhalten
arbeitswillig	Verhalten
arbeitsfreudig	Verhalten
arbeitsunwillig	Verhalten
arbeitsscheu	Verhalten
energisch	Verhalten
energiegeladen	Verhalten
dynamisch	Verhalten
leistungsfähig	Verhalten
ehrgeizig	Verhalten
strebsam	Verhalten
energisch	Verhalten
bemüht	Verhalten
bestrebt	Verhalten
rührig	Verhalten
zielstrebig	Verhalten
zielbewusst	Verhalten
zielgesteuert	Verhalten
zielorientiert	Verhalten
engagiert	Verhalten
ambitioniert	Verhalten
lebhaft	Verhalten
temperamentvoll	Verhalten
feurig	Verhalten
energisch	Verhalten
quirlig	Verhalten
umtriebig	Verhalten
munter	Verhalten
rege	Verhalten
hierarchisch orientiert	Verhalten
egalitär	Verhalten
elitär	Verhalten
snobistisch	Verhalten
versnobt	Verhalten
autoritär	Verhalten
antiautoritär	Verhalten
obrigkeitstreu	Verhalten
obrigkeitsgläubig	Verhalten
untertänig	Verhalten
wohlerzogen	Verhalten
anständig	Verhalten
schamhaft	Verhalten
prüde	Verhalten
gesittet	Verhalten
sittsam	Verhalten
vornehm	Verhalten
höflich	Verhalten
salonfähig	Verhalten
gesellschaftsfähig	Verhalten
damenhaft	Verhalten
sittlich	Verhalten
keusch	Verhalten
nonnenhaft	Verhalten
enthaltsam	Verhalten
abstinent	Verhalten
entsagend	Verhalten
entsagungsvoll	Verhalten
zuvorkommend	Verhalten
entgegenkommend	Verhalten
kompromissbereit	Verhalten
hilfsbereit	Verhalten
gefällig	Verhalten
hilfreich	Verhalten
fürsorglich	Verhalten
väterlich	Verhalten
mütterlich	Verhalten
wohlmeinend	Verhalten
gutgemeint	Verhalten
wohlwollend	Verhalten
schützend	Verhalten
behütend	Verhalten
behilflich	Verhalten
konstruktiv	Verhalten
fördernd	Verhalten
förderlich	Verhalten
gesundheitsförderlich	Verhalten
gesundheitsdienlich	Verhalten
gesund	Verhalten
gesundheitsabträglich	Verhalten
regenerativ	Verhalten
erholsam	Verhalten
entspannend	Verhalten
aufmerksam	Verhalten
galant	Verhalten
diskret	Verhalten
taktvoll	Verhalten
indiskret	Verhalten
taktlos	Verhalten
formell	Verhalten
gehorsam	Verhalten
willfährig	Verhalten
gefügig	Verhalten
fügsam	Verhalten
folgsam	Verhalten
ungehorsam	Verhalten
rebellisch	Verhalten
aufständisch	Verhalten
widerspenstig	Verhalten
aufsässig	Verhalten
aufmüpfig	Verhalten
renitent	Verhalten
trotzig	Verhalten
stur	Verhalten
störrisch	Verhalten
aufrührerisch	Verhalten
aufwieglerisch	Verhalten
bockig	Verhalten
verstockt	Verhalten
verbockt	Verhalten
eigenwillig	Verhalten
eigenmächtig	Verhalten
eigensinnig	Verhalten
eigen	Verhalten
brav	Verhalten
artig	Verhalten
frech	Verhalten
unhöflich	Verhalten
unmanierlich	Verhalten
ungebührlich	Verhalten
despektierlich	Verhalten
verächtlich	Verhalten
missfällig	Verhalten
abfällig	Verhalten
abschätzig	Verhalten
flegelhaft	Verhalten
lümmelhaft	Verhalten
pöbelhaft	Verhalten
ruppig	Verhalten
rüpelhaft	Verhalten
grob	Verhalten
rau	Verhalten
unsanft	Verhalten
unflätig	Verhalten
ehrfürchtig	Verhalten
ehrerbietig	Verhalten
ehrerbietend	Verhalten
andächtig	Verhalten
respektvoll	Verhalten
manierlich	Verhalten
zurückhaltend	Verhalten
distanziert	Verhalten
schüchtern	Verhalten
verschämt	Verhalten
verdruckst	Verhalten
reserviert	Verhalten
spröde	Verhalten
menschenscheu	Verhalten
kontaktarm	Verhalten
zurückgezogen	Verhalten
bescheiden	Verhalten
genügsam	Verhalten
kleinlaut	Verhalten
asketisch	Verhalten
anspruchsvoll	Verhalten
unbescheiden	Verhalten
einfach	Verhalten
schlicht	Verhalten
unprätentiös	Verhalten
dreist	Verhalten
dummdreist	Verhalten
tolldreist	Verhalten
berechnend	Verhalten
opportunistisch	Verhalten
anbiedernd	Verhalten
frühreif	Verhalten
aufdringlich	Verhalten
distanzlos	Verhalten
penetrant	Verhalten
unaufdringlich	Verhalten
stolz	Verhalten
hochnäsig	Verhalten
überheblich	Verhalten
abgehoben	Verhalten
arrogant	Verhalten
herablassend	Verhalten
aufgeblasen	Verhalten
blasiert	Verhalten
dünkelhaft	Verhalten
hochfliegend	Verhalten
hochtrabend	Verhalten
größenwahnsinnig	Verhalten
abgedreht	Verhalten
verblendet	Verhalten
eingebildet	Verhalten
geckenhaft	Verhalten
anmaßend	Verhalten
besserwisserisch	Verhalten
lehrerhaft	Verhalten
altklug	Verhalten
eitel	Verhalten
selbstgefällig	Verhalten
selbstherrlich	Verhalten
selbstgerecht	Verhalten
geziert	Verhalten
affektiert	Verhalten
affig	Verhalten
natürlich	Verhalten
ungezwungen	Verhalten
uneitel	Verhalten
nonchalent	Verhalten
lässig	Verhalten
mondän	Verhalten
weltgewandt	Verhalten
gekünstelt	Verhalten
manieriert	Verhalten
unnatürlich	Verhalten
herrisch	Verhalten
dominant	Verhalten
tonangebend	Verhalten
demütigend	Verhalten
unterwürfig	Verhalten
devot	Verhalten
kriecherisch	Verhalten
demütig	Verhalten
überlegen	Verhalten
unterlegen	Verhalten
treu	Verhalten
getreu	Verhalten
untreu	Verhalten
treulos	Verhalten
treuelos	Verhalten
abtrünnig	Verhalten
illoyal	Verhalten
loyal	Verhalten
linientreu	Verhalten
patriotisch	Verhalten
altgedient	Verhalten
ergeben	Verhalten
hingebungsvoll	Verhalten
gesetzestreu	Verhalten
regierungstreu	Verhalten
schwierig	Verhalten
kompliziert	Verhalten
unberechenbar	Verhalten
unkalkulierbar	Verhalten
gemeingefährlich	Verhalten
unkompliziert	Verhalten
pflegeleicht	Verhalten
berechenbar	Verhalten
kalkulierbar	Verhalten
mutig	Verhalten
beherzt	Verhalten
tapfer	Verhalten
wacker	Verhalten
gefasst	Verhalten
beherrscht	Verhalten
reckenhaft	Verhalten
heldenhaft	Verhalten
heroisch	Verhalten
waghalsig	Verhalten
kühn	Verhalten
wagemutig	Verhalten
tollkühn	Verhalten
todesmutig	Verhalten
feige	Verhalten
ängstlich	Verhalten
furchtsam	Verhalten
scheu	Verhalten
schüchtern	Verhalten
verschüchtert	Verhalten
zaghaft	Verhalten
unsicher	Verhalten
verunsichert	Verhalten
irritiert	Verhalten
irregeleitet	Verhalten
unentschieden	Verhalten
unentschlossen	Verhalten
unschlüssig	Verhalten
schwankend	Verhalten
angstvoll	Verhalten
bang	Verhalten
bange	Verhalten
schreckhaft	Verhalten
verängstigt	Verhalten
verschreckt	Verhalten
eingeschüchtert	Verhalten
erschrocken	Verhalten
vernünftig	Verhalten
rational	Verhalten
unbeherrscht	Verhalten
jähzornig	Verhalten
cholerisch	Verhalten
hitzig	Verhalten
uneinsichtig	Verhalten
vergnügungssüchtig	Verhalten
hedonistisch	Verhalten
besonnen	Verhalten
weitsichtig	Verhalten
einsichtig	Verhalten
schuldbewusst	Verhalten
reuig	Verhalten
reuevoll	Verhalten
zerknirscht	Verhalten
vorsichtig	Verhalten
vorsorglich	Verhalten
prophylaktisch	Verhalten
vorbeugend	Verhalten
präventiv	Verhalten
behutsam	Verhalten
sacht	Verhalten
sachte	Verhalten
pflegsam	Verhalten
pfleglich	Verhalten
schonend	Verhalten
überlegt	Verhalten
logisch	Verhalten
schlüssig	Verhalten
folgerichtig	Verhalten
stringent	Verhalten
stimmig	Verhalten
systematisch	Verhalten
planvoll	Verhalten
zielgerichtet	Verhalten
zielsicher	Verhalten
abwägend	Verhalten
bedachtsam	Verhalten
bedächtig	Verhalten
bedacht	Verhalten
lustig	Verhalten
fröhlich	Verhalten
heiter	Verhalten
albern	Verhalten
schelmisch	Verhalten
schalkhaft	Verhalten
possenhaft	Verhalten
spaßig	Verhalten
spaßhaft	Verhalten
amüsant	Verhalten
vergnüglich	Verhalten
lausbübisch	Verhalten
lausbubenhaft	Verhalten
verschmitzt	Verhalten
pflichtbewusst	Verhalten
umweltbewusst	Verhalten
zuverlässig	Verhalten
verlässlich	Verhalten
verschwiegen	Verhalten
pflichteifrig	Verhalten
pflichtgetreu	Verhalten
verantwortungsvoll	Verhalten
verantwortungsbewusst	Verhalten
pünktlich	Verhalten
korrekt	Verhalten
gewissenhaft	Verhalten
preußisch	Verhalten
ordentlich	Verhalten
ordnungsliebend	Verhalten
sorgsam	Verhalten
sorgfältig	Verhalten
achtsam	Verhalten
peinlich	Verhalten
penibel	Verhalten
förmlich	Verhalten
pedantisch	Verhalten
reinlich	Verhalten
methodisch	Verhalten
fahrlässig	Verhalten
inkorrekt	Verhalten
unzuverlässig	Verhalten
nachlässig	Verhalten
säumig	Verhalten
unpünktlich	Verhalten
unordentlich	Verhalten
schlampig	Verhalten
lieblos	Verhalten
oberflächlich	Verhalten
verantwortungslos	Verhalten
unverantwortlich	Verhalten
unverantwortbar	Verhalten
unverzeihlich	Verhalten
unentschuldbar	Verhalten
unverbindlich	Verhalten
unvernünftig	Verhalten
irrational	Verhalten
kindhaft	Verhalten
kindisch	Verhalten
blagisch	Verhalten
unlogisch	Verhalten
unklug	Verhalten
abergläubisch	Verhalten
verrückt	Verhalten
bekloppt	Verhalten
doll	Verhalten
jeck	Verhalten
narrenhaft	Verhalten
närrisch	Verhalten
unbesonnen	Verhalten
unvorsichtig	Verhalten
unüberlegt	Verhalten
stark	Verhalten
absolut	Verhalten
souverän	Verhalten
unumschränkt	Verhalten
mächtig	Verhalten
machtvoll	Verhalten
selbstsicher	Verhalten
selbstbewusst	Verhalten
sicher	Verhalten
souverän	Verhalten
staatsmännisch	Verhalten
siegessicher	Verhalten
siegesbewusst	Verhalten
siegesgewiss	Verhalten
durchsetzungsfähig	Verhalten
schlagkräftig	Verhalten
konfliktfähig	Verhalten
streitbar	Verhalten
kompromisslos	Verhalten
konsequent	Verhalten
unbeirrbar	Verhalten
eigenständig	Verhalten
selbstständig	Verhalten
schwach	Verhalten
hilflos	Verhalten
verloren	Verhalten
labil	Verhalten
gefährdet	Verhalten
instabil	Verhalten
beeinflussbar	Verhalten
verführbar	Verhalten
rückfällig	Verhalten
suchtgefährdet	Verhalten
unfallgefährdet	Verhalten
suizidgefährdet	Verhalten
selbstmordgefährdet	Verhalten
inkonsequent	Verhalten
halbherzig	Verhalten
unselbstständig	Verhalten
sozial	Verhalten
integrativ	Verhalten
gemeinnützig	Verhalten
gesellig	Verhalten
kontaktfreudig	Verhalten
dankbar	Verhalten
altruistisch	Verhalten
uneigennützig	Verhalten
selbstlos	Verhalten
aufopferungsvoll	Verhalten
unsozial	Verhalten
egoistisch	Verhalten
eigennützig	Verhalten
selbstsüchtig	Verhalten
ausgrenzend	Verhalten
schneidend	Verhalten
intolerant	Verhalten
engstirnig	Verhalten
borniert	Verhalten
unverbesserlich	Verhalten
exzentrisch	Verhalten
ausgeflippt	Verhalten
flippig	Verhalten
durchgeknallt	Verhalten
egozentrisch	Verhalten
verwöhnt	Verhalten
verzärtelt	Verhalten
verzogen	Verhalten
verhätschelt	Verhalten
offen	Verhalten
steif	Verhalten
zugeknöpft	Verhalten
abweisend	Verhalten
ablehnend	Verhalten
zurückweisend	Verhalten
stocksteif	Verhalten
liberal	Verhalten
freiheitlich	Verhalten
tolerant	Verhalten
weltoffen	Verhalten
direkt	Verhalten
freimütig	Verhalten
unverblümt	Verhalten
extrovertiert	Verhalten
extravertiert	Verhalten
offenherzig	Verhalten
aufgeschlossen	Verhalten
gewogen	Verhalten
hold	Verhalten
empfänglich	Verhalten
geneigt	Verhalten
mitteilsam	Verhalten
kommunikativ	Verhalten
kommunikationsfreudig	Verhalten
impulsiv	Verhalten
unumwunden	Verhalten
unverhohlen	Verhalten
unverdeckt	Verhalten
unversteckt	Verhalten
entschieden	Verhalten
entschlossen	Verhalten
resolut	Verhalten
erklärt	Verhalten
spontan	Verhalten
begeisterungsfähig	Verhalten
geradlinig	Verhalten
gradlinig	Verhalten
ehrlich	Verhalten
vertrauenswürdig	Verhalten
wahrheitsgemäß	Verhalten
vertrauenerweckend	Verhalten
vertrauensbildend	Verhalten
vertrauensfördernd	Verhalten
glaubwürdig	Verhalten
überzeugend	Verhalten
aufrichtig	Verhalten
aufrecht	Verhalten
unverdorben	Verhalten
unschuldig	Verhalten
rein	Verhalten
vertrauensvoll	Verhalten
naiv	Verhalten
unbedarft	Verhalten
treuherzig	Verhalten
blauäugig	Verhalten
Leichtgläubig	Verhalten
gutgläubig	Verhalten
verschlossen	Verhalten
unzugänglich	Verhalten
eigenbrötlerisch	Verhalten
sonderlich	Verhalten
kauzig	Verhalten
verschroben	Verhalten
bedeckt	Verhalten
introvertiert	Verhalten
indirekt	Verhalten
intrigant	Verhalten
umständlich	Verhalten
weitschweifig	Verhalten
unehrlich	Verhalten
unredlich	Verhalten
scheinheilig	Verhalten
bigott	Verhalten
heuchlerisch	Verhalten
falsch	Verhalten
unaufrichtig	Verhalten
verlogen	Verhalten
lügnerisch	Verhalten
argwöhnisch	Verhalten
misstrauisch	Verhalten
skeptisch	Verhalten
stutzig	Verhalten
zweifelnd	Verhalten
zweiflerisch	Verhalten
link	Verhalten
fragwürdig	Verhalten
verschlagen	Verhalten
verdorben	Verhalten
luderhaft	Verhalten
unanständig	Verhalten
verwerflich	Verhalten
verworfen	Verhalten
sittenlos	Verhalten
unsittlich	Verhalten
unmoralisch	Verhalten
ungehobelt	Verhalten
wüst	Verhalten
zügellos	Verhalten
ausschweifend	Verhalten
liederlich	Verhalten
lasterhaft	Verhalten
dekadent	Verhalten
heruntergekommen	Verhalten
entartet	Verhalten
sündig	Verhalten
sündhaft	Verhalten
verrucht	Verhalten
anstößig	Verhalten
frivol	Verhalten
pikant	Verhalten
schamlos	Verhalten
ordinär	Verhalten
vulgär	Verhalten
obszön	Verhalten
zwanghaft	Verhalten
befangen	Verhalten
unfrei	Verhalten
unfreiwillig	Verhalten
gezwungen	Verhalten
zähneknirschend	Verhalten
widerwillig	Verhalten
unwillig	Verhalten
widerstrebend	Verhalten
gehemmt	Verhalten
verklemmt	Verhalten
krampfartig	Verhalten
verkrampft	Verhalten
verkniffen	Verhalten
krampfig	Verhalten
krampfhaft	Verhalten
betreten	Verhalten
beklommen	Verhalten
bedingt	Verhalten
bestimmt	Verhalten
abhängig	Verhalten
frei	Verhalten
unbefangen	Verhalten
freiwillig	Verhalten
unaufgefordert	Verhalten
willig	Verhalten
bereitwillig	Verhalten
geständig	Verhalten
anstellig	Verhalten
gesprächsbereit	Verhalten
zwanglos	Verhalten
unabhängig	Verhalten
autonom	Verhalten
autark	Verhalten
sparsam	Verhalten
geizig	Verhalten
knickerig	Verhalten
knickrig	Verhalten
knauserig	Verhalten
knausrig	Verhalten
freigebig	Verhalten
freigiebig	Verhalten
großzügig	Verhalten
generös	Verhalten
gönnerhaft	Verhalten
verschwenderisch	Verhalten
freundlich	Verhalten
wohlgesonnen	Verhalten
wohlgesinnt	Verhalten
gesinnt	Verhalten
freundschaftlich	Verhalten
kameradschaftlich	Verhalten
partnerschaftlich	Verhalten
kumpelhaft	Verhalten
jovial	Verhalten
einladend	Verhalten
verbindlich	Verhalten
kollegial	Verhalten
menschlich	Verhalten
menschenwürdig	Verhalten
menschenfreundlich	Verhalten
human	Verhalten
philanthropisch	Verhalten
humanitär	Verhalten
nett	Verhalten
sonnig	Verhalten
unfreundlich	Verhalten
feindlich	Verhalten
verfeindet	Verhalten
feindschaftlich	Verhalten
feindselig	Verhalten
griesgrämig	Verhalten
miesepetrig	Verhalten
muffelig	Verhalten
barsch	Verhalten
gutmütig	Verhalten
großherzig	Verhalten
gutherzig	Verhalten
edelmütig	Verhalten
edel	Verhalten
friedlich	Verhalten
friedliebend	Verhalten
friedfertig	Verhalten
blutig	Verhalten
unblutig	Verhalten
barmherzig	Verhalten
aggressiv	Verhalten
angriffslustig	Verhalten
kampfeslustig	Verhalten
kampflustig	Verhalten
forsch	Verhalten
kriegerisch	Verhalten
demagogisch	Verhalten
hetzerisch	Verhalten
aufhetzend	Verhalten
aufwiegelnd	Verhalten
zänkisch	Verhalten
zanksüchtig	Verhalten
streitsüchtig	Verhalten
gehässig	Verhalten
bissig	Verhalten
spitz	Verhalten
spöttisch	Verhalten
spitzfindig	Verhalten
scharfzüngig	Verhalten
schnippisch	Verhalten
ausfallend	Verhalten
beleidigend	Verhalten
höhnisch	Verhalten
zynisch	Verhalten
ironisch	Verhalten
sarkastisch	Verhalten
provozierend	Verhalten
provokativ	Verhalten
herausfordernd	Verhalten
ungezogen	Verhalten
vorlaut	Verhalten
vollmundig	Verhalten
lautstark	Verhalten
unverschämt	Verhalten
unverfroren	Verhalten
impertinent	Verhalten
undankbar	Verhalten
großkotzig	Verhalten
großspurig	Verhalten
angeberisch	Verhalten
prahlerisch	Verhalten
großmäulig	Verhalten
schlagfertig	Verhalten
keck	Verhalten
nervös	Verhalten
unruhig	Verhalten
hypernervös	Verhalten
hysterisch	Verhalten
aufgelöst	Verhalten
hektisch	Verhalten
fieberhaft	Verhalten
ruhig	Verhalten
gelassen	Verhalten
ausgeglichen	Verhalten
schweigsam	Verhalten
wortkarg	Verhalten
stoisch	Verhalten
unaufgeregt	Verhalten
betulich	Verhalten
beschaulich	Verhalten
häuslich	Verhalten
unausgeglichen	Verhalten
sprunghaft	Verhalten
wankelmütig	Verhalten
launisch	Verhalten
kapriziös	Verhalten
launenhaft	Verhalten
flatterig	Verhalten
flatterhaft	Verhalten
kribbelig	Verhalten
zickig	Verhalten
kiebig	Verhalten
disharmonisch	Verhalten
verquer	Verhalten
gereizt	Verhalten
genervt	Verhalten
geladen	Verhalten
gestresst	Verhalten
grantig	Verhalten
geduldig	Verhalten
ausdauernd	Verhalten
beharrlich	Verhalten
hartnäckig	Verhalten
unnachgiebig	Verhalten
unermüdlich	Verhalten
unentwegt	Verhalten
unverdrossen	Verhalten
unverzagt	Verhalten
ungeduldig	Verhalten
unwirsch	Verhalten
ungehalten	Verhalten
still	Verhalten
schlafwandlerisch	Verhalten
zufrieden	Verhalten
unzufrieden	Verhalten
locker	Verhalten
unverkrampft	Verhalten
cool	Verhalten
salopp	Verhalten
verspielt	Verhalten
spielerisch	Verhalten
neckisch	Verhalten
tierspezifisch	Verhalten
wild	Verhalten
ungezähmt	Verhalten
zahm	Verhalten
gezähmt	Verhalten
keifig	Verhalten
hart	Verhalten
erziehungsspezifisch	Verhalten
streng	Verhalten
gestreng	Verhalten
rigid	Verhalten
starrköpfig	Verhalten
starr	Verhalten
rigoros	Verhalten
orthodox	Verhalten
matronenhaft	Verhalten
drastisch	Verhalten
drakonisch	Verhalten
repressiv	Verhalten
unterdrückerisch	Verhalten
einschneidend	Verhalten
massiv	Verhalten
strikt	Verhalten
permissiv	Verhalten
locker	Verhalten
nachgiebig	Verhalten
flexibel	Verhalten
sanft	Verhalten
mild	Verhalten
lasch	Verhalten
leger	Verhalten
sittenstreng	Verhalten
puritanisch	Verhalten
geschicklichkeitsspezifisch	Verhalten
geschickt	Verhalten
fingerfertig	Verhalten
akribisch	Verhalten
patent	Verhalten
gewandt	Verhalten
wendig	Verhalten
behend	Verhalten
smart	Verhalten
beredt	Verhalten
beredsam	Verhalten
eloquent	Verhalten
wortgewaltig	Verhalten
wortgewandt	Verhalten
wortreich	Verhalten
ungeschickt	Verhalten
unbeholfen	Verhalten
plump	Verhalten
grob	Verhalten
derb	Verhalten
grobschlächtig	Verhalten
linkisch	Verhalten
tölpelhaft	Verhalten
tölpisch	Verhalten
tolpatschig	Verhalten
trampelhaft	Verhalten
beziehungsspezifisch	Verhalten
ausländerfeindlich	Verhalten
fremdenfeindlich	Verhalten
rassistisch	Verhalten
antisemitisch	Verhalten
judenfeindlich	Verhalten
frauenfeindlich	Verhalten
umweltfeindlich	Verhalten
verfassungsfeindlich	Verhalten
staatsfeindlich	Verhalten
familienfeindlich	Verhalten
familienfreundlich	Verhalten
familiengerecht	Verhalten
kinderfreundlich	Verhalten
kinderfeindlich	Verhalten
menschenfeindlich	Verhalten
ausländerfreundlich	Verhalten
bürgernah	Verhalten
frauenfreundlich	Verhalten
umweltfreundlich	Verhalten
umweltschonend	Verhalten
technikfreundlich	Verhalten
technikfeindlich	Verhalten
verbündet	Verhalten
verbunden	Verhalten
verliebt	Verhalten
innig	Verhalten
nah	Verhalten
eng	Verhalten
hautnah	Verhalten
verknallt	Verhalten
verschossen	Verhalten
entflammt	Verhalten
sympathiespezifisch	Verhalten
beliebt	Verhalten
gelitten	Verhalten
anerkannt	Verhalten
geschätzt	Verhalten
geehrt	Verhalten
vergöttert	Verhalten
verehrt	Verhalten
gelobt	Verhalten
gehuldigt	Verhalten
hochgelobt	Verhalten
vielgepriesen	Verhalten
geliebt	Verhalten
gemocht	Verhalten
umschwärmt	Verhalten
umworben	Verhalten
bewundert	Verhalten
renommiert	Verhalten
berühmt	Verhalten
unbeliebt	Verhalten
ungeliebt	Verhalten
unliebsam	Verhalten
missliebig	Verhalten
verhasst	Verhalten
angesehen	Verhalten
geachtet	Verhalten
beleumundet	Verhalten
sagenumwoben	Verhalten
sagenumrankt	Verhalten
skandalumwoben	Verhalten
skandalumrankt	Verhalten
vielbeschworen	Verhalten
beschworen	Verhalten
verrufen	Verhalten
berüchtigt	Verhalten
verschrien	Verhalten
verpönt	Verhalten
erledigt	Verhalten
ruiniert	Verhalten
verachtet	Verhalten
populär	Verhalten
bekannt	Verhalten
prominent	Verhalten
namhaft	Verhalten
begehrt	Verhalten
gefragt	Verhalten
umkämpft	Verhalten
unpopulär	Verhalten
unbekannt	Verhalten
willkommen	Verhalten
erwünscht	Verhalten
unwillkommen	Verhalten
ungebeten	Verhalten
uneingeladen	Verhalten
unverstanden	Verhalten
missverstanden	Verhalten
eingeladen	Verhalten
geladen	Verhalten
gewollt	Verhalten
unerwünscht	Verhalten
ungewollt	Verhalten
neigungsspezifisch	Verhalten
naschhaft	Verhalten
vernascht	Verhalten
schleckig	Verhalten
leckermäulig	Verhalten
schwatzhaft	Verhalten
geschwätzig	Verhalten
redelustig	Verhalten
redselig	Verhalten
gesprächig	Verhalten
mitteilsam	Verhalten
klatschsüchtig	Verhalten
tratschsüchtig	Verhalten
eigenhändig	Verhalten
unreflektiert	Verhalten
gewünscht	Verhalten
kleinkriminell	Verhalten
deutschfeindlich	Verhalten
antideutsch	Verhalten
großmütig	Verhalten
großväterlich	Verhalten
katzenartig	Verhalten
nicht systematisch	Verhalten
unartig	Verhalten
fischartig	Verhalten
barschartig	Verhalten
hundeartig	Verhalten
hart	Verhalten
unbarmherzig	Verhalten
fest	Verhalten
unerbittlich	Verhalten
verschärft	Verhalten
nicht neutral	Verhalten
nicht aktiv	Verhalten
zwischenmenschlich	Verhalten
wasserabweisend	Verhalten
schmutzabweisend	Verhalten
zeitspezifisch	Zeit
zeitlich	Zeit
einleitend	Zeit
initial	Zeit
initiativ	Zeit
abschließend	Zeit
final	Zeit
perspektivisch	Zeit
zeitperspektivisch	Zeit
zurückblickend	Zeit
rückblickend	Zeit
retrospektiv	Zeit
vorausschauend	Zeit
vorausblickend	Zeit
prophetisch	Zeit
visionär	Zeit
früh	Zeit
erst-	Zeit
erstmalig	Zeit
vorzeitig	Zeit
rechtzeitig	Zeit
zeitig	Zeit
frühzeitig	Zeit
vorweggenommen	Zeit
vorgezogen	Zeit
verschoben	Zeit
verlegt	Zeit
umgelegt	Zeit
pünktlich	Zeit
überpünktlich	Zeit
unpünktlich	Zeit
verspätet	Zeit
fortgeschritten	Zeit
überfällig	Zeit
abgelaufen	Zeit
verstrichen	Zeit
termingerecht	Zeit
fristgerecht	Zeit
spät	Zeit
letzt-	Zeit
nachträglich	Zeit
rückwirkend	Zeit
postum	Zeit
posthum	Zeit
einmalig	Zeit
plötzlich	Zeit
abrupt	Zeit
mehrmalig	Zeit
zweimalig	Zeit
dreimalig	Zeit
viermalig	Zeit
fünfmalig	Zeit
sechsmalig	Zeit
siebenmalig	Zeit
achtmalig	Zeit
neunmalig	Zeit
zehnmalig	Zeit
häufig	Zeit
selten	Zeit
rar	Zeit
weiter	Zeit
vermehrt	Zeit
wiederholt	Zeit
wiederkehrend	Zeit
regelmäßig	Zeit
minütlich	Zeit
stündlich	Zeit
täglich	Zeit
saisonal	Zeit
jahreszeitlich	Zeit
ganztägig	Zeit
ganzjährig	Zeit
alltäglich	Zeit
tagtäglich	Zeit
allabendlich	Zeit
allmorgendlich	Zeit
werktäglich	Zeit
sonntäglich	Zeit
wöchentlich	Zeit
allwöchentlich	Zeit
monatlich	Zeit
allmonatlich	Zeit
jährlich	Zeit
alljährlich	Zeit
halbjährlich	Zeit
vierteljährlich	Zeit
jahrelang	Zeit
jahrzehntelang	Zeit
jahrhundertelang	Zeit
jahrtausendelang	Zeit
lebenslang	Zeit
lebenslänglich	Zeit
monatelang	Zeit
wochenlang	Zeit
tagelang	Zeit
stundenlang	Zeit
minutenlang	Zeit
nächtelang	Zeit
erneut	Zeit
neuerlich	Zeit
nochmalig	Zeit
dauerspezifisch	Zeit
einwöchig	Zeit
mehrwöchig	Zeit
zweiwöchig	Zeit
dreiwöchig	Zeit
vierwöchig	Zeit
fünfwöchig	Zeit
sechswöchig	Zeit
siebenwöchig	Zeit
achtwöchig	Zeit
neunwöchig	Zeit
zehnwöchig	Zeit
einmonatig	Zeit
mehrmonatig	Zeit
zweimonatig	Zeit
dreimonatig	Zeit
viermonatig	Zeit
fünfmonatig	Zeit
sechsmonatig	Zeit
halbjährig	Zeit
siebenmonatig	Zeit
achtmonatig	Zeit
neunmonatig	Zeit
zehnmonatig	Zeit
elfmonatig	Zeit
eintägig	Zeit
mehrtägig	Zeit
zweitägig	Zeit
dreitägig	Zeit
viertägig	Zeit
fünftägig	Zeit
sechstägig	Zeit
siebentägig	Zeit
achttägig	Zeit
neuntägig	Zeit
zehntägig	Zeit
elftägig	Zeit
zwölftägig	Zeit
dreizehntägig	Zeit
vierzehntägig	Zeit
einstündig	Zeit
mehrstündig	Zeit
zweistündig	Zeit
dreistündig	Zeit
vierstündig	Zeit
fünfstündig	Zeit
sechsstündig	Zeit
siebenstündig	Zeit
achtstündig	Zeit
neunstündig	Zeit
zehnstündig	Zeit
elfstündig	Zeit
zwölfstündig	Zeit
halbtägig	Zeit
dreizehnstündig	Zeit
vierzehnstündig	Zeit
fünfzehnstündig	Zeit
sechzehnstündig	Zeit
siebzehnstündig	Zeit
achtzehnstündig	Zeit
neunzehnstündig	Zeit
zwanzigstündig	Zeit
einundzwanzigstündig	Zeit
zweiundzwanzigstündig	Zeit
dreiundzwanzigstündig	Zeit
vierundzwanzigstündig	Zeit
andauernd	Zeit
fortwährend	Zeit
dauernd	Zeit
permanent	Zeit
stetig	Zeit
unablässig	Zeit
unbefristet	Zeit
kontinuierlich	Zeit
fortgesetzt	Zeit
ungebrochen	Zeit
chronisch	Zeit
akut	Zeit
scharf	Zeit
vordringlich	Zeit
schlagartig	Zeit
urplötzlich	Zeit
heftig	Zeit
jäh	Zeit
sequenziell	Zeit
fortlaufend	Zeit
sukzessiv	Zeit
aufeinanderfolgend	Zeit
beständig	Zeit
konstant	Zeit
gewohnheitsmäßig	Zeit
notorisch	Zeit
gleichbleibend	Zeit
unverändert	Zeit
wertbeständig	Zeit
werterhaltend	Zeit
ununterbrochen	Zeit
durchgängig	Zeit
durchgehend	Zeit
periodisch	Zeit
turnusmäßig	Zeit
turnunsgemäß	Zeit
zyklisch	Zeit
unregelmäßig	Zeit
zeitweise	Zeit
temporär	Zeit
gelegentlich	Zeit
sporadisch	Zeit
zeitweilig	Zeit
unterbrochen	Zeit
unbeständig	Zeit
veränderlich	Zeit
wechselhaft	Zeit
wechselvoll	Zeit
flüchtig	Zeit
zunehmend	Zeit
abnehmend	Zeit
verringernd	Zeit
nachlassend	Zeit
sinkend	Zeit
degressiv	Zeit
rezessiv	Zeit
abflauend	Zeit
rückläufig	Zeit
zurückgehend	Zeit
rückgängig	Zeit
baldig	Zeit
nah	Zeit
vorläufig	Zeit
einstweilig	Zeit
provisorisch	Zeit
behelfsmäßig	Zeit
vorübergehend	Zeit
zwischenzeitlich	Zeit
punktuell	Zeit
zeitpunktbezogen	Zeit
kommissarisch	Zeit
kurzlebig	Zeit
dringend	Zeit
dringlich	Zeit
ernstlich	Zeit
bevorstehend	Zeit
aufkommend	Zeit
aufkeimend	Zeit
jetzig	Zeit
derzeitig	Zeit
momentan	Zeit
augenblicklich	Zeit
heutig	Zeit
bisherig	Zeit
diesjährig	Zeit
gegenwärtig	Zeit
zeitgenössisch	Zeit
gleichzeitig	Zeit
neu	Zeit
neuartig	Zeit
originär	Zeit
innovativ	Zeit
erneuernd	Zeit
avantgardistisch	Zeit
futuristisch	Zeit
bahnbrechend	Zeit
revolutionär	Zeit
brandneu	Zeit
nagelneu	Zeit
aktuell	Zeit
laufend	Zeit
unwidersprochen	Zeit
unwiderlegt	Zeit
kursierend	Zeit
virulent	Zeit
neugeboren	Zeit
neugeschaffen	Zeit
neugegründet	Zeit
topaktuell	Zeit
brandaktuell	Zeit
neuest	Zeit
ultimativ	Zeit
frischgebacken	Zeit
frischgekürt	Zeit
modern	Zeit
neumodisch	Zeit
unmodern	Zeit
rückständig	Zeit
zurückgeblieben	Zeit
in	Zeit
angesagt	Zeit
kultig	Zeit
neuzeitlich	Zeit
mega-in	Zeit
ultramodern	Zeit
hochmodern	Zeit
out	Zeit
anachronistisch	Zeit
gegenläufig	Zeit
progressiv	Zeit
fortschrittlich	Zeit
zeitgemäß	Zeit
up to date	Zeit
zivilisiert	Zeit
aufgeklärt	Zeit
technikgläubig	Zeit
technikorientiert	Zeit
unkonventionell	Zeit
trendgemäß	Zeit
modebewußt	Zeit
nachzeitig	Zeit
künftig	Zeit
zukünftig	Zeit
angehend	Zeit
zukunftsbezogen	Zeit
zukunftsorientiert	Zeit
designiert	Zeit
werdend	Zeit
anschließend	Zeit
morgig	Zeit
kommend	Zeit
drohend	Zeit
dräuend	Zeit
nächst-	Zeit
darauf folgend	Zeit
folgend	Zeit
nachfolgend	Zeit
anhängig	Zeit
anhängend	Zeit
vergangen	Zeit
anfänglich	Zeit
ehemalig	Zeit
vormalig	Zeit
damalig	Zeit
einstig	Zeit
einstmalig	Zeit
gestrig	Zeit
vorig	Zeit
vorherig	Zeit
zurückliegend	Zeit
kürzlich	Zeit
letztjährig	Zeit
vorjährig	Zeit
alt	Zeit
klassisch	Zeit
historisch	Zeit
geschichtsträchtig	Zeit
antik	Zeit
konventionell	Zeit
traditionell	Zeit
konservativ	Zeit
restaurativ	Zeit
erzkonservativ	Zeit
reaktionär	Zeit
althergebracht	Zeit
altmodisch	Zeit
unzeitgemäß	Zeit
überholt	Zeit
antiquiert	Zeit
veraltet	Zeit
museal	Zeit
obsolet	Zeit
überaltert	Zeit
vorsintflutlich	Zeit
steinzeitlich	Zeit
altbacken	Zeit
langjährig	Zeit
morgendlich	Zeit
abendlich	Zeit
nächtlich	Zeit
mittäglich	Zeit
vorweihnachtlich	Zeit
kurz	Zeit
kurzzeitig	Zeit
kurzfristig	Zeit
langfristig	Zeit
längerfristig	Zeit
mittelfristig	Zeit
prompt	Zeit
unverzüglich	Zeit
postwendend	Zeit
überstürzt	Zeit
überhastet	Zeit
sofortig	Zeit
unmittelbar	Zeit
fristlos	Zeit
umgehend	Zeit
schnellstmöglich	Zeit
rasch	Zeit
schnell	Zeit
knapp	Zeit
verkürzt	Zeit
bündig	Zeit
schlagwortartig	Zeit
stichwortartig	Zeit
einsilbig	Zeit
lakonisch	Zeit
kurzgefasst	Zeit
endlich	Zeit
lang	Zeit
ewig	Zeit
unendlich	Zeit
unvergänglich	Zeit
zeitlos	Zeit
immerwährend	Zeit
unvergessen	Zeit
unvergesslich	Zeit
unsterblich	Zeit
vergänglich	Zeit
sterblich	Zeit
fortdauernd	Zeit
beständig	Zeit
ständig	Zeit
nachhaltig	Zeit
ausführlich	Zeit
ausgiebig	Zeit
detailliert	Zeit
detailgetreu	Zeit
endlos	Zeit
unaufhörlich	Zeit
allmählich	Zeit
schrittweise	Zeit
langwierig	Zeit
schleichend	Zeit
anhaltend	Zeit
dauerhaft	Zeit
langlebig	Zeit
langwährend	Zeit
ausgedehnt	Zeit
gestreckt	Zeit
gespannt	Zeit
langgezogen	Zeit
langatmig	Zeit
geschwindigkeitsspezifisch	Zeit
still	Zeit
langsam	Zeit
andante	Zeit
andantino	Zeit
allegro	Zeit
allegretto	Zeit
adagio	Zeit
largo	Zeit
larghetto	Zeit
schleppend	Zeit
lahm	Zeit
gemächlich	Zeit
stockend	Zeit
getragen	Zeit
schnell	Zeit
geschwind	Zeit
hurtig	Zeit
zeitgleich	Zeit
simultan	Zeit
live	Zeit
blitzschnell	Zeit
blitzartig	Zeit
rasant	Zeit
explosionsartig	Zeit
flink	Zeit
wieselflink	Zeit
flott	Zeit
fix	Zeit
zügig	Zeit
rapid	Zeit
rapide	Zeit
hastig	Zeit
eilig	Zeit
vorschnell	Zeit
voreilig	Zeit
kometenhaft	Zeit
fluchtartig	Zeit
altersspezifisch	Zeit
jung	Zeit
jugendlich	Zeit
kindlich	Zeit
kindhaft	Zeit
mädchenhaft	Zeit
jungenhaft	Zeit
bubenhaft	Zeit
knabenhaft	Zeit
alt	Zeit
greisenhaft	Zeit
greisig	Zeit
vergreist	Zeit
mumienhaft	Zeit
uralt	Zeit
steinalt	Zeit
senil	Zeit
neu	Zeit
unberührt	Zeit
jungfräulich	Zeit
unangetastet	Zeit
alt	Zeit
einjährig	Zeit
mehrjährig	Zeit
zweijährig	Zeit
dreijährig	Zeit
vierjährig	Zeit
fünfjährig	Zeit
sechsjährig	Zeit
siebenjährig	Zeit
achtjährig	Zeit
9-jährig	Zeit
neunjährig	Zeit
zehnjährig	Zeit
11-jährig	Zeit
elfjährig	Zeit
zwölfjährig	Zeit
dreizehnjährig	Zeit
vierzehnjährig	Zeit
fünfzehnjährig	Zeit
sechzehnjährig	Zeit
siebzehnjährig	Zeit
achtzehnjährig	Zeit
neunzehnjährig	Zeit
zwanzigjährig	Zeit
dreißigjährig	Zeit
40-jährig	Zeit
vierzigjährig	Zeit
gewohnheitsspezifisch	Zeit
normal	Zeit
durchschnittlich	Zeit
mittelmäßig	Zeit
mittel	Zeit
mäßig	Zeit
serienmäßig	Zeit
standardmäßig	Zeit
überdurchschnittlich	Zeit
unterdurchschnittlich	Zeit
selbstverständlich	Zeit
selbstredend	Zeit
mittler-	Zeit
üblich	Zeit
herkömmlich	Zeit
gebräuchlich	Zeit
landläufig	Zeit
gängig	Zeit
ortsüblich	Zeit
handelsüblich	Zeit
haushaltsüblich	Zeit
branchenüblich	Zeit
routinemäßig	Zeit
gewohnt	Zeit
gewöhnlich	Zeit
alltäglich	Zeit
werktäglich	Zeit
sonntäglich	Zeit
typisch	Zeit
prototypisch	Zeit
stereotypisch	Zeit
stereotyp	Zeit
zivil	Zeit
unnormal	Zeit
abnorm	Zeit
anomal	Zeit
ungewohnt	Zeit
ungewöhnlich	Zeit
außergewöhnlich	Zeit
originell	Zeit
gewöhnungsbedürftig	Zeit
einmalig	Zeit
einzigartig	Zeit
abwegig	Zeit
verwegen	Zeit
unerwartet	Zeit
überraschend	Zeit
ungeahnt	Zeit
unerahnt	Zeit
unverhofft	Zeit
unvermutet	Zeit
erstaunlich	Zeit
seltsam	Zeit
verwunderlich	Zeit
wundersam	Zeit
wunderlich	Zeit
fantastisch	Zeit
regelwidrig	Zeit
normwidrig	Zeit
verfassungswidrig	Zeit
gesetzwidrig	Zeit
sittenwidrig	Zeit
rechtswidrig	Zeit
widerrechtlich	Zeit
wahrheitswidrig	Zeit
unüblich	Zeit
untypisch	Zeit
einheitlich	Zeit
uneinheitlich	Zeit
bundeseinheitlich	Zeit
landeseinheitlich	Zeit
staatseinheitlich	Zeit
truppeneinheitlich	Zeit
einförmig	Zeit
gleichförmig	Zeit
uniform	Zeit
gleichmäßig	Zeit
einhellig	Zeit
übereinstimmend	Zeit
regelmäßig	Zeit
ebenmäßig	Zeit
regelhaft	Zeit
geregelt	Zeit
entstehend	Zeit
beginnend	Zeit
ruckartig	Zeit
stichprobenartig	Zeit
stichpunktartig	Zeit
großjährig	Zeit
nicht flüchtig	Zeit
nicht periodisch	Zeit
nicht klassisch	Zeit
konsekutiv	Zeit
nicht konstant	Zeit
nicht ständig	Zeit
überfallartig	Zeit
handstreichartig	Zeit
nahtlos	Zeit
verzögerungslos	Zeit
nicht konsekutiv	Zeit
nicht nachhaltig	Zeit
anstehend	Zeit
nachstehend	Zeit
vorbei	Zeit
vorüber	Zeit
aus	Zeit
gegessen	Zeit
passiert	Zeit
diskontinuierlich	Zeit
stoßweise	Zeit
schubweise	Zeit
